!	! ‼ ⁉ ❕ ❗
!!	!! ‼
#	# #️⃣
%	% 🔣
&	& 🔣
+	+ ➕
+1	+1 👍
-	- ➖
-1	-1 👎
0	0 🕖 🕙 0️⃣
1	1 👁 🕐 🕜 1️⃣
10	10 🕙 🕥 🔟
100	100 💯 💶
10:00	10:00 🕙
10:30	10:30 🕥
11	11 🕚 🕦
11:00	11:00 🕚
11:30	11:30 🕦
12	12 🕛 🕧
1234	1234 🔢
12:00	12:00 🕛
12:30	12:30 🕧
143	143 😍 😗 😚 😙 😒 💘 💝 💖 💗 💓 💞 💕 💟 🩷 🧡 💛 💚 💙 🩵 💜 🤎 🩶 🤍
18	18 🔞
1:00	1:00 🕐
1:30	1:30 🕜
1st	1st 🥇
2	2 🕑 🕝 2️⃣
24	24 🏪
2:00	2:00 🕑
2:30	2:30 🕝
2nd	2nd 🥈
3	3 🥰 🕒 🕞 3️⃣
30	30 🕧 🕜 🕝 🕞 🕟 🕠 🕡 🕢 🕣 🕤 🕥 🕦
3:00	3:00 🕒
3:30	3:30 🕞
3rd	3rd 🥉
4	4 🍀 🕓 🕟 4️⃣
4:00	4:00 🕓
4:30	4:30 🕟
5	5 ✋ 🕔 🕠 5️⃣
5:00	5:00 🕔
5:30	5:30 🕠
5–0	5–0 🚓
6	6 🕕 🕡 6️⃣
6:00	6:00 🕕
6:30	6:30 🕡
7	7 🕖 🕢 7️⃣
7:00	7:00 🕖
7:30	7:30 🕢
8	8 🕗 🕣 🎱 8️⃣
8:00	8:00 🕗
8:30	8:30 🕣
8ball	8ball 🎱
9	9 🕘 🕤 9️⃣
9:00	9:00 🕘
9:30	9:30 🕤
<3	<3 🫰 🫶
a+	a+ 💯
ab	ab 🆎
abacus	abacus 🧮
abc	abc 🔤
abcd	abcd 🔠 🔡
absentminded	absentminded 😶‍🌫️
absolutely	absolutely 👊
absorbing	absorbing 🧽
acceptable	acceptable 🉑
access	access ♿
accessibility	accessibility 🦾 🦿 🦻 🧏 🧏‍♂️ 🧏‍♀️ 🧑‍🦯 🧑‍🦯‍➡️ 👨‍🦯 👨‍🦯‍➡️ 👩‍🦯 👩‍🦯‍➡️ 🧑‍🦼 🧑‍🦼‍➡️ 👨‍🦼 👨‍🦼‍➡️ 👩‍🦼 👩‍🦼‍➡️ 🧑‍🦽 🧑‍🦽‍➡️ 👨‍🦽 👨‍🦽‍➡️ 👩‍🦽 👩‍🦽‍➡️ 🦮 🐕‍🦺 🛗
accident	accident 🫗
accordion	accordion 🪗
accounting	accounting 🧾
acidity	acidity 🍋‍🟩
act	act 🤹 🤹‍♂️ 🤹‍♀️
action	action 🎬
active	active 🤸 🤸‍♂️ 🤸‍♀️
actor	actor 🧑‍🎤 👨‍🎤 👩‍🎤 🎭
actress	actress 🎭
address	address 📢
adhesive	adhesive 🩹
admiration	admiration 🥹
admission	admission 🎟 🎫
adorable	adorable 🩷
adorbs	adorbs 😘 💘 💞 🐶
adore	adore 🥰
adult	adult 🧑 👨 👨‍🦰 👨‍🦱 👨‍🦳 👨‍🦲 👩 👩‍🦰 🧑‍🦰 👩‍🦱 🧑‍🦱 👩‍🦳 🧑‍🦳 👩‍🦲 🧑‍🦲 🧓 👴 👵 🧑‍🧑‍🧒 🧑‍🧑‍🧒‍🧒
aerial	aerial 🚡
aeroplane	aeroplane ✈ 🛩 🛫 🛬
aesculapius	aesculapius ⚕
af	af 🔥
afghanistan	afghanistan 🇦🇫
afraid	afraid 😨
africa	africa 🌍
afro	afro 🦱 🪮
again	again 🤦 🤦‍♂️ 🤦‍♀️ 🔄
age	age 🔞
agree	agree 💯 👊
agreement	agreement 🤝
aid	aid 🦻 ⛑ 🩼
air	air 🪟
airplane	airplane ✈ 🛩 🛫 🛬
alarm	alarm 🚨 ⏰
albania	albania 🇦🇱
alces	alces 🫎
alcohol	alcohol 🍷 🍸 🍹 🍺 🍻
ale	ale 🍺
alembic	alembic ⚗
alert	alert 🚨
algeria	algeria 🇩🇿
alien	alien 👽 👾
aliens	aliens 🛸 📡
almond	almond 🌰
alpaca	alpaca 🦙
alpha	alpha 🦁
alphabet	alphabet 🔤
alternation	alternation 〽
amazed	amazed 😳
amazement	amazement 🫢
amble	amble 🚶 🚶‍♂️ 🚶‍♀️ 🚶‍➡️ 🚶‍♀️‍➡️ 🚶‍♂️‍➡️
ambulance	ambulance 🚑
american	american 🏈
americansamoa	americansamoa 🇦🇸
americas	americas 🌎
amoeba	amoeba 🦠
amount	amount 🤏 🈷
amphora	amphora 🏺
amulet	amulet 🧿 🪬
amusement	amusement 🛝 🎡 🎢
anatomical	anatomical 🫀
anchor	anchor ⚓ 🔱
andorra	andorra 🇦🇩
angel	angel 😇 👼
angelic	angelic 😇 🪽
angels	angels 😇
anger	anger 😤 😡 😠 💢 🗯
angle	angle 📏 📐
angola	angola 🇦🇴
angry	angry 😤 😡 😠 👿 👺 💢 🗯
anguilla	anguilla 🇦🇮
anguished	anguished 😧
animal	animal 😺 😸 😹 😻 😼 😽 🙀 😿 😾 🙉 🙊 🐵 🐒 🦍 🦧 🐶 🐕 🦮 🐕‍🦺 🐩 🐺 🦊 🦝 🐱 🐈 🐈‍⬛ 🦁 🐯 🐅 🐆 🐴 🫎 🫏 🐎 🦓 🦌 🦬 🐮 🐂 🐃 🐄 🐷 🐖 🐗 🐽 🐏 🐑 🐐 🐪 🐫 🦙 🦒 🐘 🦣 🦏 🦛 🐭 🐁 🐀 🐹 🐰 🐇 🐿 🦫 🦔 🦇 🐻 🐻‍❄️ 🐨 🐼 🦦 🦨 🦘 🦡 🐔 🐓 🐣 🐤 🐥 🐦 🐧 🦅 🦆 🦢 🦉 🦤 🦩 🦚 🦜 🐦‍⬛ 🪿 🐸 🐊 🐢 🦎 🐍 🐲 🐉 🐳 🐋 🐬 🦭 🐟 🐠 🐡 🦈 🐙 🐚 🪼 🦞 🦑 🐌 🐛 🐜 🐝 🪲 🐞 🦗 🪳 🕷 🪰 🪱
animals	animals 🐕 🐈 🐂 🐄 🐁
ankle	ankle 🦶
annelid	annelid 🪱
anniversary	anniversary 💝 💞 💕 💏 👩‍❤️‍💋‍👨 👨‍❤️‍💋‍👨 👩‍❤️‍💋‍👩 💑 👩‍❤️‍👨 👨‍❤️‍👨 👩‍❤️‍👩 💐
annoyed	annoyed 😖 🙍 🙍‍♂️ 🙍‍♀️
answer	answer 🟰
ant	ant 🐜
antarctica	antarctica 🐧 🇦🇶
antenna	antenna 📡 📶
anticlockwise	anticlockwise 🔄
antigua	antigua 🇦🇬
antlers	antlers 🫎
anxious	anxious 😟 😨 😰 😥 🫦
ape	ape 🦧
apocalypse	apocalypse 🧟 🧟‍♂️ 🧟‍♀️
apology	apology 🙇 🙇‍♂️ 🙇‍♀️
applause	applause 👏
apple	apple 🍎 🍏 🥧
application	application 🈸
appreciate	appreciate 🙏
apprehend	apprehend 👮 👮‍♂️ 👮‍♀️
approval	approval 👏
aquarium	aquarium 🪼
aquarius	aquarius 🏺 ♒
archer	archer 🏹 ♐
archery	archery 🏹
architect	architect 🧑‍💼 👨‍💼 👩‍💼
arctic	arctic 🐻‍❄️
arepa	arepa 🫓
argentina	argentina 🇦🇷
aries	aries 🐏 ♈
arm	arm 💪 🦾
armenia	armenia 🇦🇲
army	army 🪖
arrest	arrest 👮 👮‍♂️ 👮‍♀️
arrival	arrival 🛬
arrivals	arrivals 🛬
arrived	arrived 🚆 🚈 🛄
arriving	arriving 🛬
arrow	arrow 💘 📲 📩 🏹 ⬆ ↗ ➡ ↘ ⬇ ↙ ⬅ ↖ ↕ ↔ ↩ ↪ ⤴ ⤵ 🔃 🔄 🔙 🔚 🔛 🔜 🔝 🔀 🔁 🔂 ▶ ⏩ ⏭ ⏯ ◀ ⏪ ⏮ 🔼 ⏫ 🔽 ⏬
arrows	arrows 🔃 🔄
art	art 🎭 🖼 🎨
articulated	articulated 🚛
artist	artist 🧑‍🎨 👨‍🎨 👩‍🎨
arts	arts 🥋 🎭
artsy	artsy 🎨
arty	arty 🎨
aruba	aruba 🇦🇼
ascend	ascend 🪽 🐦‍🔥
ascension	ascension 🐦‍🔥
ascensionisland	ascensionisland 🇦🇨
ashes	ashes ⚱
asia	asia 🌏
asia-australia	asia-australia 🌏
ask	ask 🙏 🙇 🙇‍♂️ 🙇‍♀️
ass	ass 🫏
assassin	assassin 🥷
assembly	assembly 🧑‍🏭 👨‍🏭 👩‍🏭
assistance	assistance 🐕‍🦺
asterisk	asterisk ✳
astonished	astonished 😲
astronaut	astronaut 🧑‍🚀 👨‍🚀 👩‍🚀
astronomy	astronomy ⭐
at	at 🫵 🌆 🌉
atheist	atheist ⚛
athletic	athletic ⛹ ⛹️‍♂️ ⛹️‍♀️ 👟
athletics	athletics 🤾 🤾‍♂️ 🤾‍♀️ 🎽
atm	atm 🏧
atom	atom ⚛
attraction	attraction 🧲
aubergine	aubergine 🍆
australia	australia 🐨 🌏 🇦🇺
austria	austria 🇦🇹
auto	auto 🛺
automated	automated 🏧
automobile	automobile 🚗 🚘 🛻
autumn	autumn 🍂 🥮
aviation	aviation 🪽
avocado	avocado 🥑
award	award 🎖 🏅
away	away 💨
awe	awe 🫢 😒
awesome	awesome 😃 😛 😎 👌 👏 🎉
awful	awful 😔 😢 😞
awk	awk 😬
awkward	awkward 😐 😑 😶 😬 😳
aww	aww 🥹
ax	ax 🪓
axe	axe 🪓
azerbaijan	azerbaijan 🇦🇿
b	b 🅱
baa	baa 🐑
babe	babe 💏 👩‍❤️‍💋‍👨 👨‍❤️‍💋‍👨 👩‍❤️‍💋‍👩 💑 👩‍❤️‍👨 👨‍❤️‍👨 👩‍❤️‍👩
babies	babies 👶 🍼
babooshka	babooshka 🪆
baboushka	baboushka 🪆
babushka	babushka 🪆
baby	baby 👶 🤱 👩‍🍼 👨‍🍼 🧑‍🍼 👼 🐣 🐤 🐥 🚼
back	back 🥹 🤚 🚪 🔙
backhand	backhand 🤚 👈 👉 👆 👇
backpack	backpack 🎒
backpacking	backpacking 🎒 🥾
bacon	bacon 🐷 🐖 🥓
bacteria	bacteria 🦠 🧫
bactrian	bactrian 🐫
bad	bad 👎 🦹 🦹‍♂️ 🦹‍♀️
badge	badge 📛
badger	badger 🦡
badminton	badminton 🏸
bae	bae 😍 😘 😚 😒 🧑‍🤝‍🧑 👭 👫 👬 💏 👩‍❤️‍💋‍👨 👨‍❤️‍💋‍👨 👩‍❤️‍💋‍👩 💑 👩‍❤️‍👨 👨‍❤️‍👨 👩‍❤️‍👩
bag	bag 🧳 👜 👝 🛍 🎒 💰
bagel	bagel 🥯
baggage	baggage 🛄 🛅
bags	bags 🫩 🛍 🛄
baguette	baguette 🥖
bahamas	bahamas 🇧🇸
bahrain	bahrain 🇧🇭
bait	bait 🪤
bakery	bakery 🥯 🧁
balance	balance 🤹 🤹‍♂️ 🤹‍♀️ ⚖ ♎
balancing	balancing 🤹 🤹‍♂️ 🤹‍♀️
bald	bald 👨‍🦲 👩‍🦲 🧑‍🦲 👴
ball	ball 🏌 🏌️‍♂️ 🏌️‍♀️ ⛹ ⛹️‍♂️ ⛹️‍♀️ 🤾 🤾‍♂️ 🤾‍♀️ 🍙 🎊 ⚽ ⚾ 🥎 🏀 🏐 🏈 🏉 🎾 🎳 🏏 🏑 🥍 🏓 🎱 🔮 🪩 🧶
ballet	ballet 🥿 🩰
balloon	balloon 💬 👁️‍🗨️ 🗯 💭 🎈
ballot	ballot 🗳 ☑
ballpoint	ballpoint 🖊
bamboo	bamboo 🐼 🎍
banana	banana 🐵 🐒 🍌
band	band 🪈
bandage	bandage 🤕 🩹
bandana	bandana 🧕
bangbang	bangbang ‼
bangladesh	bangladesh 🇧🇩
banjo	banjo 🪕
bank	bank 🏦 💰 💴 💵 💶 💷 💸 💳 💹 🏧 💱
banknote	banknote 💴 💵 💶 💷 💸
banner	banner 🎋
bar	bar 🍫 🍶 🍾 🍷 🍸 🍹 🍺 🍻 🏮 📊 🧼 ⏸ 📶
barbados	barbados 🇧🇧
barbell	barbell 🏋 🏋️‍♂️ 🏋️‍♀️
barber	barber 💇 💇‍♂️ 💇‍♀️ 💈
barbuda	barbuda 🇦🇬
bare	bare 🪾
barefoot	barefoot 👣
barf	barf 🤮
bargain	bargain 🉐
barrel	barrel 🍯
barren	barren 🪾
barrier	barrier 🚧
bars	bars 📶
baseball	baseball ⚾ 🧢
baseballcap	baseballcap 🧢
basket	basket 🧺
basketball	basketball ⛹ ⛹️‍♂️ ⛹️‍♀️ 🏀
bat	bat 🦇 🏏 🏓
bath	bath 🛀 🛁
bathing	bathing 🩱 🩲 🩳 👙 🧼
bathroom	bathroom 🚽 🪥 🚹 🚺 🚻 🚾
bathtub	bathtub 🛀 🛁
battery	battery 🔋 🪫
bawling	bawling 😭
bday	bday 🥳 🎂
beach	beach 😎 🏄 🏄‍♂️ 🏄‍♀️ 🐳 🐋 🐬 🐚 🌴 🏖 🌞 👙 🩴
beacon	beacon 🚨
bead	bead 🧿
beads	beads 📿
beak	beak 🐦‍⬛
beaming	beaming 😁
beans	beans 🫘 🫛
beanstalk	beanstalk 🫛
bear	bear 🐻 🐻‍❄️ 🐨 🍯 🧸
beard	beard 🧔 🧔‍♂️ 🧔‍♀️
bearded	bearded 🧔 🧔‍♂️ 🧔‍♀️
bearer	bearer 🐍 ♒ ⛎
beast	beast 💪
beat	beat 🫀 🪘
beating	beating 💓
beauty	beauty 👄 💇 💇‍♂️ 💇‍♀️ 🪷 🌹
beaver	beaver 🦫
beckon	beckon 🫴
bed	bed 😴 🛌 🛏
bedtime	bedtime 😴 🥱 🛌
bee	bee 🐝
beer	beer 🫚 🍺 🍻
beet	beet 🫜
beetle	beetle 🪲 🐞
befuddled	befuddled 😕
beg	beg 🙏 🙇 🙇‍♂️ 🙇‍♀️
begging	begging 🥺
beginner	beginner 🔰
behind	behind ⛅ 🌤 🌥 🌦
belarus	belarus 🇧🇾
belgium	belgium 🇧🇪
believe	believe 😮
belize	belize 🇧🇿
bell	bell 🫑 🛎 🎐 🔔 🔕
bellhop	bellhop 🛎
belly	belly 🫃 🫄
bench	bench 💪
benin	benin 🇧🇯
bent	bent 🦵 🧢
bento	bento 🍱
bermuda	bermuda 🇧🇲
berries	berries 🍒 🫐
berry	berry 🍓 🫐
bestest	bestest 💜
bestie	bestie 👯 👯‍♂️ 👯‍♀️ 🧑‍🤝‍🧑 👭 👫 👬
bet	bet 👌 💰
beverage	beverage ☕ 🍵 🍶 🍷 🧃
bewhiskered	bewhiskered 🧔
bewilder	bewilder 🤦 🤦‍♂️ 🤦‍♀️
bff	bff 👯 👯‍♂️ 👯‍♀️ 🧑‍🤝‍🧑 👭 👫 👬 👥
bhutan	bhutan 🇧🇹
biceps	biceps 💪
bicycle	bicycle 🚴 🚴‍♂️ 🚴‍♀️ 🚵 🚵‍♂️ 🚵‍♀️ 🚲 🚳
bicycles	bicycles 🚳
bicyclist	bicyclist 🚴 🚴‍♂️ 🚴‍♀️ 🚵 🚵‍♂️ 🚵‍♀️
big	big 😃 😒 🥺 🐯 🐅 🐆
bike	bike 🚴 🚴‍♂️ 🚴‍♀️ 🚵 🚵‍♂️ 🚵‍♀️ 🚲 🔐 🚳
biking	biking 🚴 🚴‍♂️ 🚴‍♀️ 🚵 🚵‍♂️ 🚵‍♀️
bikini	bikini 👙
bilberry	bilberry 🫐
bill	bill 💴 💵 💶 💷 💸
billed	billed 🧢
billiard	billiard 🎱
billion	billion 💰 💷 💸 💲
billionaire	billionaire 🚤
bin	bin 🚮
biohazard	biohazard ☣
biologist	biologist 🧑‍🔬 👨‍🔬 👩‍🔬 🧫 🧬
biology	biology 🧫
bird	bird 🦃 🐔 🐓 🐣 🐤 🐥 🐦 🐧 🕊 🦅 🦆 🦢 🦉 🦤 🪶 🦩 🦚 🦜 🪽 🐦‍⬛ 🪿 🪺
birdie	birdie 🏌 🏌️‍♂️ 🏌️‍♀️ 🏸
birth	birth 🍼
birthday	birthday 🥳 💐 🎂 🎈 🎉 🎁
bisexual	bisexual 🏳️‍🌈
bison	bison 🦬
bisque	bisque 🦞
bit	bit 🤏
bite	bite 🫦 🦟
biting	biting 🫦
black	black 🖤 🐈‍⬛ 🐦‍⬛ ✒ ⚫ ◼ ◾ ▪ 🔲 🏴
blades	blades 🛼
blame	blame 😨 😞 😠
blank	blank 😐 😶
bleed	bleed 🩸
bless	bless ⛪
blessed	blessed 😇 🙏
blind	blind 🧑‍🦯 🧑‍🦯‍➡️ 👨‍🦯 👨‍🦯‍➡️ 👩‍🦯 👩‍🦯‍➡️ 🦮
bloated	bloated 🫃 🫄
block	block 🫷 🫸
blond	blond 👱 👱‍♀️ 👱‍♂️
blond-haired	blond-haired 👱 👱‍♀️ 👱‍♂️
blonde	blonde 👱‍♀️
blood	blood 🧛 🧛‍♂️ 🧛‍♀️ 🩸 🅰 🆎 🅱 🅾
bloom	bloom 🪻
blossom	blossom 🌸 🌼 🌷
blouse	blouse 👚
blow	blow 😮‍💨 🍃 🌬
blowfish	blowfish 🐡
blowing	blowing 😘 😮‍💨
blown	blown 🤯
blu-ray	blu-ray 💿 📀
blue	blue 🥶 😰 💙 🩵 🫐 👕 👖 📘 🧿 🔵 🟦 🔷 🔹 🏳️‍⚧️
blue-faced	blue-faced 🥶
blueberries	blueberries 🫐
blueberry	blueberry 🫐
bluebonnet	bluebonnet 🪻
blush	blush 😊 😚
boar	boar 🐗
board	board 🛹 🎬
boat	boat 🚣 🚣‍♂️ 🚣‍♀️ ⛵ 🛶 🚤 ⛴ 🛥 🚢
boba	boba 🧋
body	body 💀 👂 👃 👀 👁 👅 👄
bodybuilder	bodybuilder 💪 🏋 🏋️‍♂️ 🏋️‍♀️
bok	bok 🥬
bolivia	bolivia 🇧🇴
bollywood	bollywood 🎥
bolt	bolt 🔩
bomb	bomb 💥 💣
bone	bone ☠ 🦴 🍖 🍗
bones	bones 🦴 🩻
boo	boo 👻
book	book 📔 📕 📖 📗 📘 📙 📚
bookbag	bookbag 🎒
bookkeeping	bookkeeping 🧾
bookmark	bookmark 📑 🔖
books	books 📚
boom	boom 💥 👊 🎆 🎇 💣
boomerang	boomerang 🪃
boot	boot 🥾 👢
booze	booze 🍷 🍸 🍹 🍺 🍻
bored	bored 😒 😔 🫩 🥱 💅
born	born 🍼
bosnia	bosnia 🇧🇦
boss	boss 😏
botswana	botswana 🇧🇼
bottle	bottle 🍼 🍶 🍾 🧴
bottoms	bottoms 🍻
boulder	boulder 🪨
bouncing	bouncing ⛹ ⛹️‍♂️ ⛹️‍♀️
bouquet	bouquet 💐
bouvetisland	bouvetisland 🇧🇻
bow	bow 🙏 🙇 🙇‍♂️ 🙇‍♀️ 🎁 🏹
bowing	bowing 🙇 🙇‍♂️ 🙇‍♀️
bowl	bowl 🥣 🍜 🏈
bowling	bowling 🎳
box	box 🍱 🥡 🧃 🎁 🪗 📤 📥 📦 🗳 🗃 🧰 ☑
boxing	boxing 🥊
boy	boy 👦 👨‍👩‍👦 👨‍👩‍👧‍👦 👨‍👩‍👦‍👦 👨‍👨‍👦 👨‍👨‍👧‍👦 👨‍👨‍👦‍👦 👩‍👩‍👦 👩‍👩‍👧‍👦 👩‍👩‍👦‍👦
boys	boys 👬
brachiosaurus	brachiosaurus 🦕
brain	brain 🧠
brainy	brainy 🤓
branch	branch 🪹 🪺
branches	branches 🪾
brazil	brazil 🇧🇷
brb	brb 🔜
bread	bread 🍞 🥐 🥖 🫓 🥯 🥪
break	break 💔 🔔 ⛓️‍💥
breakfast	breakfast 🥐 🥯 🥞 🧇 🥓 🥚 🍳 🥣 🍩 🍴
breaking	breaking ⛓️‍💥
breaky	breaky 🍴
breast	breast 🤱
breast-feeding	breast-feeding 🤱
breath	breath 🫁
breathe	breathe 🫁
brew	brew 🫖
brick	brick 🧱
bricks	bricks 🧱
bride	bride 👰‍♀️
bridge	bridge 🌉
briefcase	briefcase 💼
briefs	briefs 🩲
bright	bright 😎 ☀ 🌝 🌞 🔆
bright-eyed	bright-eyed 🧒 👦 👧
brightness	brightness 🔅 🔆
britishindianoceanterritory	britishindianoceanterritory 🇮🇴
britishvirginislands	britishvirginislands 🇻🇬
bro	bro 😎 👊 💪 👨 👨‍🦰 👨‍🦱 👨‍🦳 👨‍🦲
broadband	broadband 🛜
broccoli	broccoli 🥦
broken	broken 💔 ⛓️‍💥
brontosaurus	brontosaurus 🦕
bronze	bronze 🥉
broom	broom 🧹
brothers	brothers 👬
brown	brown 🤎 👞 🥾 🟤 🟫
brr	brr 🧥
bruh	bruh 👊
brunei	brunei 🇧🇳
brush	brush 🪥
bs	bs 💩
bubble	bubble 💬 👁️‍🗨️ 🗯 💭 🧋 🫧
bubbles	bubbles 🫧
bucket	bucket 🪣
buckingham	buckingham 💂 💂‍♂️ 💂‍♀️
buddhism	buddhism 🪷
buddhist	buddhist ☸
buffalo	buffalo 🦬 🐃
bug	bug 🐛 🪲 🦗
build	build 👷 👷‍♂️ 👷‍♀️ 📲
building	building 🏛 🏗 🏠 🏡 🏢 🏣 🏤 🏥 🏦 🏨 🏩 🏪 🏫 🏬 🏭 🏯 🏰 🌆 🌇
bulb	bulb 💡
bulgaria	bulgaria 🇧🇬
bull	bull 🐂 🎯 ♉
bullet	bullet 🚅
bullseye	bullseye 🎯
bumblebee	bumblebee 🐝
bump	bump 👊
bundle	bundle 🧣 🧥
bunny	bunny 👯 👯‍♂️ 👯‍♀️ 🐰 🐇
buoy	buoy 🛟
burger	burger 🍔
burgers	burgers 🥬
burkinafaso	burkinafaso 🇧🇫
burn	burn ❤️‍🔥 🪼
burp	burp 🫧
burrito	burrito 🌯
burro	burro 🫏
burundi	burundi 🇧🇮
bury	bury 🪏
bus	bus 🚋 🚌 🚍 🚎 🚐 🚏
business	business 🧑‍💼 👨‍💼 👩‍💼 🕴 🈺
busstop	busstop 🚏
bust	bust 👤 👥
busts	busts 👥
butter	butter 🧈
buttercup	buttercup 🌼
butterflies	butterflies 😟
butterfly	butterfly 🦋
button	button 🔄 🔀 🔁 🔂 ▶ ⏩ ⏭ ⏯ ◀ ⏪ ⏮ 🔼 ⏫ 🔽 ⏬ ⏸ ⏹ ⏺ ⏏ 🔅 🔆 ✅ ❎ 🅰 🆎 🅱 🆑 🆒 🆓 🆔 🆕 🆖 🅾 🆗 🅿 🆘 🆙 🆚 🈁 🈂 🈷 🈶 🈯 🉐 🈹 🈚 🈲 🉑 🈸 🈴 🈳 ㊗ ㊙ 🈺 🈵 🔘 🔳 🔲
bye	bye 👋
c	c 🍊 ©
cab	cab 🚕 🚖
cabbage	cabbage 🥬 🥦
cabbie	cabbie 🚕 🚖
cabinet	cabinet 🗄
cable	cable 🚠 🚡
cableway	cableway 🚠
caboose	caboose 🚂
cactus	cactus 🌵
caddy	caddy 🏌 🏌️‍♂️ 🏌️‍♀️
cafe	cafe ☕
caffeine	caffeine ☕
caicosislands	caicosislands 🇹🇨
cake	cake 🍥 🥮 🎂 🍰
calculation	calculation 🧮
calculator	calculator 🧮
calendar	calendar 📅 📆 🗓
call	call 😥 🤙 📲
calm	calm 😌 🪷
cambodia	cambodia 🇰🇭
camcorder	camcorder 📹
camel	camel 🐪 🐫
camera	camera 🤳 🎥 📷 📸 📹 🎦
cameroon	cameroon 🇨🇲
camping	camping 🏕 ⛺ 🥾
can	can 🥫 🗑
canada	canada 🇨🇦
canaryislands	canaryislands 🇮🇨
cancel	cancel ✖ ❌
cancer	cancer 🦀 ♋
candelabrum	candelabrum 🕎
candle	candle 🕯
candlestick	candlestick 🕎
candy	candy 🍫 🍬 🍭 🪅
cane	cane 🧑‍🦯 🧑‍🦯‍➡️ 👨‍🦯 👨‍🦯‍➡️ 👩‍🦯 👩‍🦯‍➡️ 🩼
canned	canned 🥫
canoe	canoe 🚣 🚣‍♂️ 🚣‍♀️ 🛶
cantaloupe	cantaloupe 🍈
cap	cap 👲 🎓 🧢
capeverde	capeverde 🇨🇻
capricorn	capricorn 🐐 ♑
capsicum	capsicum 🫑
captivated	captivated 🫣
car	car 🚃 🚞 🚋 🚓 🚔 🚕 🚗 🚘 🚙 🛻 🚚 🚛 🏎 🛞 🚨 🚡
carbs	carbs 🍞
card	card ♠ ♥ ♦ ♣ 🃏 🎴 💳 🗂 📇 🗃 🪧 🪪 🟥 🟨
cardiac	cardiac 💛
cardinal	cardinal ⬆ ➡ ⬇ ⬅
cardio	cardio 💓
cardiology	cardiology 🫀
cards	cards 🎴
care	care 💅
caribbeannetherlands	caribbeannetherlands 🇧🇶
carousel	carousel 🎠
carp	carp 🎏
carpenter	carpenter 🪚
carpentry	carpentry 🪚
carrot	carrot 🥕
cars	cars 🚍 🚖 🚘
cart	cart 🛒
cartoon	cartoon 💭
cartwheel	cartwheel 🤸 🤸‍♂️ 🤸‍♀️
cartwheeling	cartwheeling 🤸 🤸‍♂️ 🤸‍♀️
case	case 🛄 🛅
cash	cash 💰 💷 💸 💳 🏧 💲
casino	casino 🎰
cask	cask 🪣
casserole	casserole 🥘
castle	castle 🏯 🏰
casual	casual 👕 👖
cat	cat 😺 😸 😹 😻 😼 😽 🙀 😿 😾 🐱 🐈 🐈‍⬛ 🐯 🐅 🐆
catch	catch 🫴 🤾 🤾‍♂️ 🤾‍♀️ 🪝
cats	cats 🐈
caught	caught 😦
caution	caution ⚠
cavities	cavities 🍬
caw	caw 🐦‍⬛
caymanislands	caymanislands 🇰🇾
cd	cd 💿 📀
celebrate	celebrate 🥳 🥂 🎈 🎉 🎊 🪅
celebration	celebration 🥳 🙌 🎅 🤶 🧑‍🎄 🎂 🎃 🎆 🎇 🎈 🎉 🎊 🎋 🎍 🎎 🎏 🎐 🎑 🎀 🎁 🎗 🎖 🪅 🎓 🎌
cell	cell 📱 📲 📵 📶 📳 📴
cemetery	cemetery 🪦
censor	censor 🤬
centralafricanrepublic	centralafricanrepublic 🇨🇫
cereal	cereal 🥣
ceremony	ceremony 🎑
ceuta	ceuta 🇪🇦
cha	cha 🪇
chad	chad 🇹🇩
chai	chai ☕
chain	chain ⛓️‍💥
chains	chains ⛓
chair	chair 💺 🪑
champion	champion 🏆
championship	championship ⛹ ⛹️‍♂️ ⛹️‍♀️
champs	champs 🏆
change	change 🪸
changing	changing 🚼
chapel	chapel 💒 ⛪
charge	charge 💳 💲 🈂 🈶 🈚
charm	charm 🧿
chart	chart 💹 📈 📉 📊
check	check ✅ ☑ ✔
check-in	check-in 🛫
checked	checked 🛄 ✅ ☑ ✔
checkered	checkered 🏁
checkmark	checkmark ✅ ✔
cheerful	cheerful 😀
cheering	cheering 📣
cheers	cheers 🍻
cheery	cheery 😀
cheese	cheese 🧀 🍕 🫕 🪤
chef	chef 🧑‍🍳 👨‍🍳 👩‍🍳 🔪
chemist	chemist 🧑‍🔬 👨‍🔬 👩‍🔬 🧪
chemistry	chemistry ⚗ 🧪
chemotherapy	chemotherapy 🦲
chequered	chequered 🏁
cherries	cherries 🍒
cherry	cherry 🌸 🍒
chess	chess ♟
chest	chest 🧰
chestnut	chestnut 🌰
chevron	chevron 🔰
chick	chick 🐣 🐤 🐥
chicken	chicken 🐔 🍗
chickpea	chickpea 🧆
child	child 🧒 👦 👧 👨‍👩‍👦 👨‍👩‍👧 👨‍👩‍👧‍👦 👨‍👩‍👦‍👦 👨‍👩‍👧‍👧 👨‍👨‍👦 👨‍👨‍👧 👨‍👨‍👧‍👦 👨‍👨‍👦‍👦 👨‍👨‍👧‍👧 👩‍👩‍👦 👩‍👩‍👧 👩‍👩‍👧‍👦 👩‍👩‍👦‍👦 👩‍👩‍👧‍👧 👪 🧑‍🧑‍🧒 🧑‍🧑‍🧒‍🧒 🚸
children	children 👶 🚸
chile	chile 🇨🇱
chilling	chilling 😎
chime	chime 🎐
chin	chin 🤔
china	china 🇨🇳
chinese	chinese 👲
chip	chip 🍪
chipmunk	chipmunk 🐿
chocolate	chocolate 🫕 🍪 🍫
choo	choo 🚆
chop	chop 💇 💇‍♂️ 💇‍♀️ 🥩 🪓
chopsticks	chopsticks 🍜 🥡 🥢
choy	choy 🥬
christ	christ ✝
christian	christian ⛪ ✝ ☦
christmas	christmas 🎅 🤶 🧑‍🎄 🌲 🎁
christmasisland	christmasisland 🇨🇽
chuck	chuck 🤾 🤾‍♂️ 🤾‍♀️
church	church 👼 ⛪ 🔔
cigarette	cigarette 🚬
cinco	cinco 🪅
cinema	cinema 🎥 🎞 📽 🎦
circle	circle 🛞 ⏺ ⭕ ⓜ 🔴 🟠 🟡 🟢 🔵 🟣 🟤 ⚫ ⚪
circled	circled ⓜ
circus	circus 🎪
citation	citation 👮 👮‍♂️ 👮‍♀️
citrus	citrus 🍊 🍋 🍋‍🟩
city	city 🏢 🏙 🌆
cityscape	cityscape 🏙 🌆
cl	cl 🆑
clack	clack 🪭
claim	claim 🛄
clamp	clamp 🗜
clap	clap 👏 🪭
clapper	clapper 🎬
class	class 🚲
classical	classical 🏛
classy	classy 🧐
claus	claus 🎅 🤶 🧑‍🎄
claws	claws 🦞
clay	clay 🧱
clean	clean 🧼 🫧 🪥
cleaning	cleaning 🧹 🧼 🧽
clearly	clearly 💯
clenched	clenched ✊ 👊
clever	clever 🤓
climate	climate 🪸
climb	climb 🧗 🧗‍♂️ 🧗‍♀️ 🪜
climber	climber 🧗 🧗‍♂️ 🧗‍♀️
climbing	climbing 🧗 🧗‍♂️ 🧗‍♀️
clink	clink 🍻 🥂
clinking	clinking 🍻 🥂
clipboard	clipboard 📋
clippertonisland	clippertonisland 🇨🇵
clock	clock ⌚ ⏰ ⏱ ⏲ 🕰 🕛 🕧 🕐 🕜 🕑 🕝 🕒 🕞 🕓 🕟 🕔 🕠 🕕 🕡 🕖 🕢 🕗 🕣 🕘 🕤 🕙 🕥 🕚 🕦
clockwise	clockwise 🔃 🔁 🔂
close	close 😥 😓
closed	closed 😆 😚 😙 😝 😽 🌂 📕 📫 📪 🔒 🔐
closet	closet 🚪 🚾
clothes	clothes 🥼 👕 👖 👗 👚 👛 👜 👝 👞 👟 👠 👢 👒 🎩
clothing	clothing 👣 🌂 ☂ ☔ 👓 👔 👕 👖 👗 👘 🥻 👙 👚 👛 👜 👝 👞 👟 👠 👡 👢 👑 👒 🎩 🎓 📿
cloud	cloud 💨 💭 ☁ ⛅ ⛈ 🌤 🌥 🌦 🌧 🌨 🌩 🌪 🌫 🌬
clouds	clouds 😶‍🌫️
cloudy	cloudy ⛅
clover	clover 🍀
clown	clown 🤡
club	club 🍷 🍸 🍹 ♣
clubs	clubs ♣
clue	clue 🫆 🧩 🗝
clutch	clutch 👝
cmon	cmon 🙏
coaster	coaster 🎢
coat	coat 🥼 🧥
cockroach	cockroach 🪳
cocktail	cocktail 🍋‍🟩 🍸 🍹
coconut	coconut 🥥
cocoskeelingislands	cocoskeelingislands 🇨🇨
coder	coder 🧑‍💻 👨‍💻 👩‍💻
coffee	coffee ☕
coffin	coffin ⚰
cog	cog ⚙
cogwheel	cogwheel ⚙
coin	coin 👛 🪙
colada	colada 🍍 🥥
cold	cold 😅 😷 🥶 😰 😓 🧊 🏔 🌨 ❄ ☃ ⛄ 💧 🧣 🧥
collage	collage 📌
collar	collar 👕 👚
collide	collide 💥
collision	collision 💥
colombia	colombia 🇨🇴
colorful	colorful 🦚 🎨
comb	comb 🪮
combat	combat 🤼 🤼‍♂️ 🤼‍♀️
come	come 🫴
comet	comet ☄
comfort	comfort 🫂
comfortable	comfortable 👘
comfy	comfy 🥿
comic	comic 💩 💢 💥 💫 💦 💨 💬 💭 💤 💧 💡 💣 💠
comment	comment #️⃣
communication	communication 📢 📱 📲 📞 📟 📠 📰 📩 📦 📫 📝 📶 📳
comoros	comoros 🇰🇲
compass	compass 🧭
complete	complete ✅
completed	completed ✅
complicated	complicated 😥
compress	compress 🗜
computer	computer 🧑‍💻 👨‍💻 👩‍💻 🖥 🖨 ⌨ 🖱 🖲 💽 💾 💿 📀 🛜
concentrate	concentrate 😣
concentration	concentration 😣
concertina	concertina 🪗
conch	conch 🐚
condiment	condiment 🧂 🫙
confetti	confetti 🎊
confounded	confounded 😖
confused	confused 😵‍💫 😕 🫤 😖
confusing	confusing 😕
confusion	confusion 🫤
conga	conga 🪘
congee	congee 🥣
congo-brazzaville	congo-brazzaville 🇨🇬
congo-kinshasa	congo-kinshasa 🇨🇩
congrats	congrats 👏
congratulations	congratulations 👏 ㊗
connectivity	connectivity 🛜
consider	consider 🤔
construction	construction 👷 👷‍♂️ 👷‍♀️ 🏗 🚧 🚩
contact	contact 🔎 🔭 📡
container	container 🫙
control	control 🎛 🛂
controller	controller 🎮
convenience	convenience 🏪
convoluted	convoluted 🥨
cook	cook 🧑‍🍳 👨‍🍳 👩‍🍳
cooked	cooked 🍚
cookie	cookie 🥠 🍪
cooking	cooking 🍳 🍽 🍴 🔪 🏺
cookislands	cookislands 🇨🇰
cool	cool 😛 😎 🪭 🆒
cooling	cooling 🪭
cop	cop 👮 👮‍♂️ 👮‍♀️
cops	cops 🚓
copter	copter 🚁
copyright	copyright ©
coral	coral 🪸
cord	cord 🪢
cork	cork 🍾
corn	corn 🌽 🍿
correct	correct 👊
corvid	corvid 🐦‍⬛
cosmetics	cosmetics 💅 💄
cosmetology	cosmetology 💇 💇‍♂️ 💇‍♀️
cost	cost 😲 😫 💰
costarica	costarica 🇨🇷
couch	couch 🛋
counterclockwise	counterclockwise 🔄
counterpart	counterpart 👯 👯‍♂️ 👯‍♀️
country	country 🏠 🏡
couple	couple 🧑‍🤝‍🧑 👭 👫 👬 💏 👩‍❤️‍💋‍👨 👨‍❤️‍💋‍👨 👩‍❤️‍💋‍👩 💑 👩‍❤️‍👨 👨‍❤️‍👨 👩‍❤️‍👩
cover	cover 📔
cow	cow 🐮 🐄
cowboy	cowboy 🤠
cowgirl	cowgirl 🤠
crab	crab 🦀 ♋
cracked	cracked 🔓
cracker	cracker 🍘
crane	crane 🏗
crayon	crayon 🖍
crazy	crazy 😜 🤪 🫨 😳
cream	cream 🍦 🍨
creative	creative 🎨
creature	creature 👹 👺 👻 👽 👾 🧜 🧜‍♂️ 🧜‍♀️ 🐙
credentials	credentials 🪪
credit	credit 💳
crescent	crescent 🥐 🌒 🌘 🌙 ☪
cricket	cricket 🦗 🏏
crime	crime 🫆
criminal	criminal 🦹 🦹‍♂️ 🦹‍♀️
cringe	cringe 😖
croatia	croatia 🇭🇷
crochet	crochet 🧶
crocodile	crocodile 🐊
croissant	croissant 🥐
crook	crook 🪝
crops	crops 🌽
cross	cross 🤞 🧘 🧘‍♂️ 🧘‍♀️ ⛪ ⛑ ✝ ☦ ❌ ❎ 🎌
crossbones	crossbones ☠
crossed	crossed 🤞 🫰 ⚔ 🔀 🎌
crossed-out	crossed-out 😵
crossing	crossing 🚸
crow	crow 🐦‍⬛
crown	crown 🫅 🤴 👸 👑
cruise	cruise 🚣 🚣‍♂️ 🚣‍♀️
crush	crush 🥰
crushed	crushed 💔
crutch	crutch 🩼
cry	cry 🥹 😢 😭 😿
crying	crying 🤣 😂 😪 😢 😭 😩 😿
crystal	crystal 🔮
crêpe	crêpe 🥞
cuba	cuba 🇨🇺
cube	cube 🧊
cubical	cubical 🏢
cucumber	cucumber 🥒
cuffs	cuffs ⛓️‍💥
culture	culture 🧫
cup	cup 🍵 🍶 🥤 🪠
cupcake	cupcake 🧁
cupid	cupid 💘 🪉
cupped	cupped 🤲
cuppedhands	cuppedhands 🤲
curaçao	curaçao 🇨🇼
curious	curious 🦝
curl	curl 📃 ➰ ➿
curling	curling 🥌
curls	curls 💪
curly	curly 🦱 ➰ ➿
curlyhair	curlyhair 👨‍🦱 👩‍🦱 🧑‍🦱
currency	currency 💴 💵 💶 💷 💹 💱 💲
curry	curry 🍛
cursing	cursing 🤬
curve	curve 🪝
curving	curving ↩ ↪ ⤴ ⤵
cussing	cussing 🤬
custard	custard 🍮
customs	customs 🛃
cut	cut 💇 💇‍♂️ 💇‍♀️ 🥩 💈 ✂ 🪚
cute	cute 🩷 🩵
cutlery	cutlery 🍴
cutting	cutting ✂
cya	cya 👋
cyan	cyan 🩵
cycle	cycle 🚴 🚴‍♂️ 🚴‍♀️ 🚵 🚵‍♂️ 🚵‍♀️ 🚲
cycling	cycling 🚲
cyclist	cyclist 🚴 🚴‍♂️ 🚴‍♀️ 🚵 🚵‍♂️ 🚵‍♀️ 🚲
cyclone	cyclone 🌀
cygnet	cygnet 🦢
cyprus	cyprus 🇨🇾
czechia	czechia 🇨🇿
côted’ivoire	côted’ivoire 🇨🇮
dad	dad 👨‍🍼 🧢
dagger	dagger 🗡
dairy	dairy 🧈
dam	dam 🦫
dance	dance 💃 🕺 🪩 🪭 🩰 🪇
dancer	dancer 💃 🕺 👯 👯‍♂️ 👯‍♀️
dancing	dancing 💃 🕺
dandelion	dandelion 🌼
danger	danger ⚡
dangerous	dangerous 💣
dango	dango 🍡
dapper	dapper 😏
dark	dark 🌑 🕶
dart	dart 🎯
dash	dash 💨 〰
dashing	dashing 💨
data	data 📈 📉 📊
date	date 😗 😚 😙 💘 💕 💏 👩‍❤️‍💋‍👨 👨‍❤️‍💋‍👨 👩‍❤️‍💋‍👩 💐 💄 📅
dating	dating 😗 😚 😙 💕 💋 🧑‍🤝‍🧑 👭 👫 👬 💏 👩‍❤️‍💋‍👨 👨‍❤️‍💋‍👨 👩‍❤️‍💋‍👩 💑 👩‍❤️‍👨 👨‍❤️‍👨 👩‍❤️‍👩
daughter	daughter 👧
david	david ✡
day	day 🧖 🧖‍♂️ 🧖‍♀️ 🌞
daydream	daydream 💭
daze	daze 🫨
dazed	dazed 😳
de	de 🪅
dead	dead 😑 😵 😳 💀 ☠ 🧟 🧟‍♂️ 🧟‍♀️ 🪾 ⚰ 🪦
deadlift	deadlift 🏋 🏋️‍♂️ 🏋️‍♀️
deadpan	deadpan 😐
deaf	deaf 🧏 🧏‍♂️ 🧏‍♀️
deal	deal 🤝
death	death 💀 ☠ ⚰ ⚱
deciduous	deciduous 🌳
decisions	decisions 💭
decor	decor 🪴
decorated	decorated 📔
decoration	decoration 💟 🎍
decorative	decorative 📔
decreasing	decreasing 📉
deer	deer 🦌
definitely	definitely 💯
deg	deg 🪯
deja	deja 🔄
dejected	dejected 😅 😔 😞
delicious	delicious 😋 🍴
delivering	delivering 📨
delivery	delivery 🥡 🚚 📦
demon	demon 😈 👿
demonstration	demonstration 🪧
denim	denim 👖
denmark	denmark 🇩🇰
dental	dental 🪥
dentist	dentist 😬 😷 🦷
department	department 🏬
departure	departure 🛫
departures	departures 🛫
depressed	depressed 🫥
derelict	derelict 🏚
dermatologist	dermatologist 😷
desert	desert 🐪 🐫 🌵 🏜 🏝
desktop	desktop 🖥
dessert	dessert 🍡 🍦 🍧 🍨 🍩 🍪 🎂 🍰 🧁 🍫 🍬 🍭 🍮
detective	detective 🕵 🕵️‍♂️ 🕵️‍♀️ 🫆
developer	developer 🧑‍💻 👨‍💻 👩‍💻
devil	devil 😈 👿 👹
dharma	dharma ☸
diagonal	diagonal 🫤
dialog	dialog 💬 🗨
diamond	diamond ♦ 💍 💎 🔶 🔷 🔸 🔹 💠
diaper	diaper 🧷
dice	dice 🎲
die	die 🎲
died	died 😔
diegogarcia	diegogarcia 🇩🇬
diesel	diesel ⛽
diet	diet 🍎
difficult	difficult ☯
dig	dig 🪏
dim	dim 🔅
dinner	dinner 🐟 🍽 🍴
dinosaur	dinosaur 🦕 🦖
dionysus	dionysus 🍇
diplodocus	diplodocus 🦕
direct	direct 🎯
direction	direction 🧭 ⬆ ↗ ➡ ↘ ⬇ ↙ ⬅ ↖
disability	disability 🩼
disappear	disappear 🫠 🫥
disappointed	disappointed 😔 🫤 😥 😞 🙍 🙍‍♂️ 🙍‍♀️ 🙎 🙎‍♂️ 🙎‍♀️
disapproval	disapproval 🤨
disbelief	disbelief 🫢 🤨 😳 🤦 🤦‍♂️ 🤦‍♀️
disc	disc 🥏
disco	disco 🪩
discount	discount 🈹
disease	disease 🦟 🪰
disgruntled	disgruntled 🙍 🙍‍♂️ 🙍‍♀️
disguise	disguise 🥸
dish	dish 🧫 📡
disk	disk 💽 💾 💿 📀
dislike	dislike 👎
dismiss	dismiss 🫳
dissolve	dissolve 🫠
distraught	distraught 😖
distrust	distrust 🤨
disturbed	disturbed 🙍 🙍‍♂️ 🙍‍♀️
dive	dive 🥽
divide	divide ➗
dividers	dividers 🗂
diving	diving 🦪 🤿
division	division ➗
diya	diya 🪔
dizzy	dizzy 🥴 😵 😵‍💫 🌀
djibouti	djibouti 🇩🇯
djinn	djinn 🧞 🧞‍♂️ 🧞‍♀️
dna	dna 🧬
do	do 📋 ⛔
doctor	doctor 😷 🧑‍⚕️ 👨‍⚕️ 👩‍⚕️ 🏥 🥼 💉 💊 🩺 🩻
document	document 📃 📄 🪪
dodo	dodo 🦤
dog	dog 🦴 🐶 🐕 🦮 🐕‍🦺 🐩 🌭
dogs	dogs 🐕
doll	doll 🎎 🪆
dollar	dollar 💰 🪙 💵 💸 💲
dolls	dolls 🎎 🪆
dolphin	dolphin 🐬
dominica	dominica 🇩🇲
dominicanrepublic	dominicanrepublic 🇩🇴
donation	donation 🩸
done	done 💅 ⌛ ⏳ ✅ ☑ ✔
donkey	donkey 🫏
donut	donut 🍩
doo	doo 💩
door	door 🚪
dope	dope 👌
dot	dot 💠
dotted	dotted 🫥 🔯
double	double 👯 👯‍♂️ 👯‍♀️ ⏩ ⏪ ⏫ ⏬ ⏸ ‼ ➿
doubt	doubt 🫤 🤷 🤷‍♂️ 🤷‍♀️
doubtful	doubtful 🫤
doughnut	doughnut 🍩
dove	dove 🕊
down	down 🫳 👇 👎 🐨 📩 📉 ⬇ ⤵ 🔽 ⏬ 🔻
down-left	down-left ↙
down-right	down-right ↘
downcast	downcast 😓
downtrodden	downtrodden 🙎 🙎‍♂️ 🙎‍♀️
downward	downward 📉
downwards	downwards 🔽
dr	dr 😷 🥼
dracula	dracula 🧛
dragon	dragon 🐲 🐉 🀄
drained	drained 🪫
dream	dream 💭
dreams	dreams 🌒 🌜
dress	dress 👗 🥻 👚 👛 👜 👝 👠 👢
dressage	dressage 🐴
dressed	dressed 👕 👖 👗 👚
dribble	dribble ⛹ ⛹️‍♂️ ⛹️‍♀️
drink	drink 🍼 🥛 ☕ 🫖 🍵 🍶 🍾 🍷 🍸 🍹 🍺 🥂 🫗 🥤 🧉 🏺
drinking	drinking 🍷 🍸 🍹 🍺 🍻 🚰
drinks	drinks 🍷 🍸 🍹 🍺 🍻
drip	drip 💦 🫟
drive	drive 🚐 🚕 🚙 🚚 🚛
driving	driving 🏌 🏌️‍♂️ 🏌️‍♀️ 🚗
dromedary	dromedary 🐪
drooling	drooling 🤤
drop	drop 🫳 ☔ 💧 🩸
droplet	droplet 💦 💧
droplets	droplets 💦
dropped	dropped 🫳
drops	drops 💦 ☔
drought	drought 🌵 🪾
drove	drove 🚖 🚘 🚦
drugs	drugs 💊
drum	drum 🛢 🥁 🪘
drumstick	drumstick 🍗
drumsticks	drumsticks 🥁
drunk	drunk 🥴 🍹
dry	dry 🚱
dua	dua 🤲
duck	duck 🦆 🪿
duckling	duckling 🦢
duel	duel 🤼 🤼‍♂️ 🤼‍♀️
dumpling	dumpling 🥟
dung	dung 💩
dunno	dunno 😕 🤷 🤷‍♂️ 🤷‍♀️
dupe	dupe ♟
dusk	dusk 🌆 🌇
dvd	dvd 💿 📀
dying	dying 🥵 🥀
dynamite	dynamite 🧨
e-mail	e-mail ✉ 📧 📨 📩
eagle	eagle 🦅
ear	ear 👂 🦻 🧏 🧏‍♂️ 🧏‍♀️ 👯 👯‍♂️ 👯‍♀️ 🌾 🌽
earbud	earbud 🎧
ears	ears 🙉 👂
earth	earth 🌍 🌎 🌏 🌐
earthquake	earthquake 🫨
earthworm	earthworm 🪱
east	east ➡
easy	easy 🍳
eat	eat 😋 😒 🍔 🍽 🍴 🥄
ecuador	ecuador 🇪🇨
edamame	edamame 🫛
edge	edge 📏
education	education 🎒 🎓 📔 📕 📖 📗 📘 📙 📚
eek	eek 😰
egg	egg 🐣 🪺 🥚 🍳
eggplant	eggplant 🍆
eggs	eggs 🪺
egypt	egypt 🇪🇬
eight	eight 🕗 🕣 🎱 8️⃣
eight-pointed	eight-pointed ✴
eight-spoked	eight-spoked ✳
eight-thirty	eight-thirty 🕣
eighteen	eighteen 🔞
eject	eject ⏏
elderly	elderly 🧓 👴 👵
electric	electric 🚃 ⚡ 🔌 💡 🔦
electrician	electrician 🧑‍🔧 👨‍🔧 👩‍🔧
electricity	electricity ⚡ 🔌
electronic	electronic 🪫
elegant	elegant 💃 🕺 🌹
elephant	elephant 🐘
elevator	elevator 🛗
eleven	eleven 🕚 🕦
eleven-thirty	eleven-thirty 🕦
elf	elf 🧝 🧝‍♂️ 🧝‍♀️
elk	elk 🫎
elsalvador	elsalvador 🇸🇻
elves	elves 🧝 🧝‍♂️ 🧝‍♀️
email	email ✉ 📧 📨 📩 📤 📥
embarrass	embarrass 🫢 🫣
embarrassed	embarrassed 🫠 😳 🥹 🙈
emblem	emblem 🔱
embrace	embrace 🫂
embroidery	embroidery 🪡
emerge	emerge 🐦‍🔥
emergency	emergency 🚑 🚨 🦺
emoji	emoji 🤨
emotion	emotion 💘 💝 💖 💗 💓 💞 💕 💟 💔 ❤ 🩷 💛 💚 💙 🩵 💜 🩶 💋 ♥
empanada	empanada 🥟
employed	employed 👔
empty	empty 🪹 🫗 🫙
enchantment	enchantment 🧝 🧝‍♂️ 🧝‍♀️
end	end 🔚
energy	energy 🪫
engaged	engaged 💍
engagement	engagement 💍 💎
engine	engine 🚂 🚒
engineer	engineer 🧑‍🔬 👨‍🔬 👩‍🔬
england	england 🏴󠁧󠁢󠁥󠁮󠁧󠁿
enraged	enraged 😡
ensnare	ensnare 🪝
entertainer	entertainer 🧑‍🎤 👨‍🎤 👩‍🎤
entertainment	entertainment 🎠 🎆 🎣 🎯 🎮 🎲 🎭 🎨 📻
entry	entry ⛔ 🚫
envelope	envelope 🧧 ✉ 📨 📩
epic	epic 😜 😯 😱
equal	equal 🟰
equality	equality 🟰
equals	equals 🟰
equatorialguinea	equatorialguinea 🇬🇶
equestrian	equestrian 🐎
equine	equine 🐴
eritrea	eritrea 🇪🇷
eruption	eruption 🌋
escargot	escargot 🐌
estonia	estonia 🇪🇪
eswatini	eswatini 🇸🇿
ethiopia	ethiopia 🇪🇹
euro	euro 🪙 💶
europe	europe 🌍
europe-africa	europe-africa 🌍
european	european 🏤 🏰
europeanunion	europeanunion 🇪🇺
evening	evening 🌆
evergreen	evergreen 🌲
everyone	everyone 👥
evidence	evidence 🧾
evil	evil 😈 👿 🙈 🙉 🙊 🖤 🦹 🦹‍♂️ 🦹‍♀️
evil-eye	evil-eye 🧿
evolution	evolution 🧬
ew	ew 🤮
ewe	ewe 🐑
exasperation	exasperation 🤦 🤦‍♂️ 🤦‍♀️
exchange	exchange 💱
excited	excited 😅 🤩 🥳 👻 💖 💗 👏 🤸 🤸‍♂️ 🤸‍♀️ 🎉
exclamation	exclamation ❣ ‼ ⁉ ❕ ❗
exercise	exercise 🙆 🙆‍♂️ 🙆‍♀️
exhalation	exhalation 🫁
exhale	exhale 😮‍💨
exhaling	exhaling 😮‍💨
exhausted	exhausted 😮‍💨 🫩
expendable	expendable ♟
expensive	expensive 🫰
experiment	experiment 🥼 🧪 🔬
expert	expert 🤓
explode	explode 🤯 💥
exploding	exploding 🤯
explosion	explosion 💣
explosive	explosive 🧨
expressionless	expressionless 😐 😑 😶
extinction	extinction 🦣 🦤
extinguish	extinguish 🧯
extinguisher	extinguisher 🧯
extra	extra 🛸
extraterrestrial	extraterrestrial 👽 👾 🔭
eye	eye 😄 😁 😊 😍 😚 😙 😜 🤪 😝 🫣 😒 😸 😻 😽 👁️‍🗨️ 👀 👓 🕶 🥽
eyebrow	eyebrow 🤨 🥸
eyeglasses	eyeglasses 👓
eyeroll	eyeroll 🙄
eyes	eyes 😃 😄 😁 😆 😊 🤩 😚 😙 🤪 😝 🫢 🙄 🫩 🥴 😵 😵‍💫 🥺 😸 😽 👀
eyewear	eyewear 👓 🕶
face	face 😀 😃 😄 😁 😆 😅 🤣 😂 🙂 🙃 🫠 😉 😊 😇 🥰 😍 🤩 😘 😗 ☺ 😚 😙 🥲 😋 😛 😜 🤪 😝 🤑 🤗 🤭 🫢 🫣 🤫 🤔 🫡 🤐 🤨 😐 😑 😶 🫥 😶‍🌫️ 😏 😒 🙄 😬 😮‍💨 🤥 🫨 😌 😔 😪 🤤 😴 🫩 😷 🤒 🤕 🤢 🤮 🤧 🥵 🥶 🥴 😵 😵‍💫 🤠 🥳 🥸 😎 🤓 🧐 😕 🫤 😟 🙁 ☹ 😯 😲 😳 🥺 🥹 😦 😧 😨 😰 😥 😢 😭 😱 😖 😣 😞 😓 😩 😫 🥱 😤 😡 😠 🤬 😈 👿 💀 ☠ 💩 🤡 👹 👺 👻 👽 👾 🤖 😺 😸 😹 😻 😼 😽 🙀 😿 😾 🙈 🙉 🙊 👀 👼 💆 💆‍♂️ 💆‍♀️ 🗣 🐵 🐶 🐺 🦊 🐱 🦁 🐯 🐴 🦄 🐮 🐷 🐽 🐭 🐹 🐰 🐻 🐨 🐼 🐸 🐲 🐳 🌚 🌛 🌜 🌝 🌞 🌬 ⛑ 🗿
facepalm	facepalm 🤦 🤦‍♂️ 🤦‍♀️
facing	facing 📄
factory	factory 🧑‍🏭 👨‍🏭 👩‍🏭
fail	fail 😞 😩 ⛔
fairy	fairy 😇 😈 👿 💀 👹 👺 👻 👽 👾 🤴 👸 👼 🎅 🤶 🧑‍🎄 🧚 🧚‍♂️ 🧚‍♀️ 🧌 🐲 🐉 🔮
fairytale	fairytale 😇 😈 👿 💀 👹 👺 👻 👽 👾 🤴 👸 👼 🧚 🧚‍♂️ 🧚‍♀️ 🧜 🧜‍♂️ 🧜‍♀️ 🐲 🐉 🔮
faithful	faithful 💯
falafel	falafel 🥙 🧆
falklandislands	falklandislands 🇫🇰
fall	fall 🍂
fallen	fallen 🍂
falling	falling 🍁 🍂 🌠
family	family 👨‍👩‍👦 👨‍👩‍👧 👨‍👩‍👧‍👦 👨‍👩‍👦‍👦 👨‍👩‍👧‍👧 👨‍👨‍👦 👨‍👨‍👧 👨‍👨‍👧‍👦 👨‍👨‍👦‍👦 👨‍👨‍👧‍👧 👩‍👩‍👦 👩‍👩‍👧 👩‍👩‍👧‍👦 👩‍👩‍👦‍👦 👩‍👩‍👧‍👧 👪 🧑‍🧑‍🧒 🧑‍🧑‍🧒‍🧒 👑
fan	fan 🪭
fancy	fancy 🧐 👗 👛 🎩
fangs	fangs 🧛 🧛‍♂️ 🧛‍♀️
fantasy	fantasy 😇 😈 👿 👹 👺 👻 👽 👾 🤴 👸 👼 🎅 🤶 🧑‍🎄 🧙 🧙‍♂️ 🧙‍♀️ 🧚 🧚‍♂️ 🧚‍♀️ 🧝 🧝‍♂️ 🧝‍♀️ 🧞 🧞‍♂️ 🧞‍♀️ 🧌 🐦‍🔥 🔮 📖 📗 📘 📙 📚
farewell	farewell 🫂
farm	farm 🐴 🐎 🐮 🐂 🐄 🐷 🐖 🐽 🐑 🐐 🌽
farmer	farmer 🧑‍🌾 👨‍🌾 👩‍🌾
farming	farming 🧺
faroeislands	faroeislands 🇫🇴
fart	fart 💨
fashion	fashion 👠
fast	fast 💨 🏃 🏃‍♂️ 🏃‍♀️ 🏃‍➡️ 🏃‍♀️‍➡️ 🏃‍♂️‍➡️ 🍔 🍟 👟 ⏩ ⏪ ⏫ ⏬
fast-forward	fast-forward ⏩
fateh	fateh 🪯
father	father 👨‍🍼 🎅
fatigued	fatigued 🫩
fatima	fatima 🪬
favor	favor 🙇 🙇‍♂️ 🙇‍♀️
fax	fax 📠
fear	fear 😨 😱 🫦
fearful	fearful 😨 😱
feather	feather 🪶
feed	feed 👩‍🍼 👨‍🍼 🧑‍🍼 🍴
feeding	feeding 🤱 👩‍🍼 👨‍🍼 🧑‍🍼
feelings	feelings 🥹
feels	feels 😂 😍 😵 😢 😖 😓 😩 😫 😤 😡 😠
feet	feet 🦶 🐾 👞
feline	feline 🐈‍⬛
female	female 🐑 ♀
fencer	fencer 🤺
fencing	fencing 🤺
ferris	ferris 🎡
ferry	ferry ⛴
festival	festival 🥮 🎎
festive	festive 💃 🕺 🪅
fetch	fetch 💁 💁‍♂️ 💁‍♀️
fever	fever 🤧 🦟
feverish	feverish 🥵
field	field 🏑
fife	fife 🪈
fight	fight 🥷
fighter	fighter 🥷
fiji	fiji 🇫🇯
file	file 📁 📂 🗃 🗄
filing	filing 🗄
filling	filling 🥧
film	film 🎥 🎞 📽 🎦
fine	fine 😐 😑 😒
finger	finger 🖐 🖖 🤞 🫰 🤘 👈 👉 👆 🖕 👇 ☝ 🫵
fingerprint	fingerprint 🫆
fingers	fingers 🖐 🤌 🤏 🤞 🤟
finish	finish 🏁
finland	finland 🇫🇮
fire	fire ❤️‍🔥 🧑‍🚒 👨‍🚒 👩‍🚒 🧨 🧯
firebird	firebird 🐦‍🔥
firecracker	firecracker 🧨
firefighter	firefighter 🧑‍🚒 👨‍🚒 👩‍🚒
firetruck	firetruck 🧑‍🚒 👨‍🚒 👩‍🚒
fireworks	fireworks 🎆 🎇 🧨
first	first 🌓 🌛 🥇
fish	fish 🐟 🐠 🐡 🦈 🍥 🎣 ♓
fishes	fishes 🐟 🐠
fishing	fishing 🚣 🚣‍♂️ 🚣‍♀️ 🦦 🐟 🎣
fist	fist ✊ 👊 🤛 🤜
five	five ✋ 🫷 🫸 🙏 🕔 🕠 5️⃣
five-thirty	five-thirty 🕠
fix	fix 👷 👷‍♂️ 👷‍♀️
fixed	fixed ✅
flag	flag ⛳ 📫 📪 📬 📭 🏁 🚩 🏴 🏳 🏳️‍🌈 🏳️‍⚧️ 🏴‍☠️ 🇦🇨 🇦🇩 🇦🇪 🇦🇫 🇦🇬 🇦🇮 🇦🇱 🇦🇲 🇦🇴 🇦🇶 🇦🇷 🇦🇸 🇦🇹 🇦🇺 🇦🇼 🇦🇽 🇦🇿 🇧🇦 🇧🇧 🇧🇩 🇧🇪 🇧🇫 🇧🇬 🇧🇭 🇧🇮 🇧🇯 🇧🇱 🇧🇲 🇧🇳 🇧🇴 🇧🇶 🇧🇷 🇧🇸 🇧🇹 🇧🇻 🇧🇼 🇧🇾 🇧🇿 🇨🇦 🇨🇨 🇨🇩 🇨🇫 🇨🇬 🇨🇭 🇨🇮 🇨🇰 🇨🇱 🇨🇲 🇨🇳 🇨🇴 🇨🇵 🇨🇷 🇨🇺 🇨🇻 🇨🇼 🇨🇽 🇨🇾 🇨🇿 🇩🇪 🇩🇬 🇩🇯 🇩🇰 🇩🇲 🇩🇴 🇩🇿 🇪🇦 🇪🇨 🇪🇪 🇪🇬 🇪🇭 🇪🇷 🇪🇸 🇪🇹 🇪🇺 🇫🇮 🇫🇯 🇫🇰 🇫🇲 🇫🇴 🇫🇷 🇬🇦 🇬🇧 🇬🇩 🇬🇪 🇬🇫 🇬🇬 🇬🇭 🇬🇮 🇬🇱 🇬🇲 🇬🇳 🇬🇵 🇬🇶 🇬🇷 🇬🇸 🇬🇹 🇬🇺 🇬🇼 🇬🇾 🇭🇰 🇭🇲 🇭🇳 🇭🇷 🇭🇹 🇭🇺 🇮🇨 🇮🇩 🇮🇪 🇮🇱 🇮🇲 🇮🇳 🇮🇴 🇮🇶 🇮🇷 🇮🇸 🇮🇹 🇯🇪 🇯🇲 🇯🇴 🇯🇵 🇰🇪 🇰🇬 🇰🇭 🇰🇮 🇰🇲 🇰🇳 🇰🇵 🇰🇷 🇰🇼 🇰🇾 🇰🇿 🇱🇦 🇱🇧 🇱🇨 🇱🇮 🇱🇰 🇱🇷 🇱🇸 🇱🇹 🇱🇺 🇱🇻 🇱🇾 🇲🇦 🇲🇨 🇲🇩 🇲🇪 🇲🇫 🇲🇬 🇲🇭 🇲🇰 🇲🇱 🇲🇲 🇲🇳 🇲🇴 🇲🇵 🇲🇶 🇲🇷 🇲🇸 🇲🇹 🇲🇺 🇲🇻 🇲🇼 🇲🇽 🇲🇾 🇲🇿 🇳🇦 🇳🇨 🇳🇪 🇳🇫 🇳🇬 🇳🇮 🇳🇱 🇳🇴 🇳🇵 🇳🇷 🇳🇺 🇳🇿 🇴🇲 🇵🇦 🇵🇪 🇵🇫 🇵🇬 🇵🇭 🇵🇰 🇵🇱 🇵🇲 🇵🇳 🇵🇷 🇵🇸 🇵🇹 🇵🇼 🇵🇾 🇶🇦 🇷🇪 🇷🇴 🇷🇸 🇷🇺 🇷🇼 🇸🇦 🇸🇧 🇸🇨 🇸🇩 🇸🇪 🇸🇬 🇸🇭 🇸🇮 🇸🇯 🇸🇰 🇸🇱 🇸🇲 🇸🇳 🇸🇴 🇸🇷 🇸🇸 🇸🇹 🇸🇻 🇸🇽 🇸🇾 🇸🇿 🇹🇦 🇹🇨 🇹🇩 🇹🇫 🇹🇬 🇹🇭 🇹🇯 🇹🇰 🇹🇱 🇹🇲 🇹🇳 🇹🇴 🇹🇷 🇹🇹 🇹🇻 🇹🇼 🇹🇿 🇺🇦 🇺🇬 🇺🇲 🇺🇳 🇺🇸 🇺🇾 🇺🇿 🇻🇦 🇻🇨 🇻🇪 🇻🇬 🇻🇮 🇻🇳 🇻🇺 🇼🇫 🇼🇸 🇽🇰 🇾🇪 🇾🇹 🇿🇦 🇿🇲 🇿🇼 🏴󠁧󠁢󠁥󠁮󠁧󠁿 🏴󠁧󠁢󠁳󠁣󠁴󠁿 🏴󠁧󠁢󠁷󠁬󠁳󠁿
flags	flags 🏁 🎌
flair	flair 💃 🕺
flamboyant	flamboyant 🦩
flame	flame 🔥
flamenco	flamenco 💃 🕺
flamingo	flamingo 🦩
flash	flash 📸
flashlight	flashlight 🔦
flat	flat 🥿
flatbed	flatbed 🛻
flatbread	flatbread 🫓 🥙
flathead	flathead 🪛
flats	flats 🥿
flautist	flautist 🪈
flavor	flavor 🧂
flavoring	flavoring 🧄 🧅
fleek	fleek 💯 👌
fleur-de-lis	fleur-de-lis ⚜
flex	flex 💪
flick	flick 💁 💁‍♂️ 💁‍♀️
flight	flight 🪶
flip	flip 💁 💁‍♂️ 💁‍♀️ 🤸 🤸‍♂️ 🤸‍♀️ 🩴
flipper	flipper 🐬
flirt	flirt 😉 😘 😗 😚 😙 😏 🫦 🧑‍🤝‍🧑 👭 👫 👬 🪭
flirting	flirting 🫦
float	float 🛟
floating	floating 🫧
flock	flock 🪿
floor	floor 🤣
flop	flop 🩴
floppy	floppy 💾
flower	flower 💐 🌸 💮 🪷 🌹 🥀 🌺 🌻 🌼 🌷 🪻 🎴
flowing	flowing ⏳
flu	flu 🤧 💉
fluctuate	fluctuate 🪀
fluffy	fluffy 🐩 🐑
flushed	flushed 😳
flute	flute 🪈
flutter	flutter 🍃 🪭
fluttering	fluttering 🍃
fly	fly 🕊 🪽 🪰 ✈ 🪁 💸
flying	flying 🪽 ✈ 🛸 🥏
fml	fml 💩
focus	focus 😣
fog	fog 😶‍🌫️ 😒 🌁
foggy	foggy 🌁
folded	folded 🙏
folder	folder 📁 📂
folding	folding 🪭
folklore	folklore 🧜 🧜‍♂️ 🧜‍♀️ 🧝 🧝‍♂️ 🧝‍♀️
fondue	fondue 🫕
food	food 😋 🦐 🦑 🥭 🍎 🫐 🥝 🍅 🫒 🥑 🥔 🥕 🫑 🥒 🥜 🫘 🍄‍🟫 🫜 🍞 🥐 🥖 🫓 🥞 🥓 🍔 🍟 🍕 🫔 🥙 🥚 🥘 🍲 🫕 🥗 🥫 🍱 🍘 🍙 🍚 🍛 🍜 🍝 🍠 🍢 🍣 🍥 🥡 🍦 🍨 🍩 🍭 🍯 🫖 🧋 🍴
foot	foot 🦵 🦶 👞
football	football ⚽ 🏈 🏉
footprint	footprint 👣
footprints	footprints 👣
forbidden	forbidden 🙈 🙉 🙊 🙅 🙅‍♂️ 🙅‍♀️ 🔕 ⛔ 🚫 🚳 🚭 🚯 🚷 📵 🔞
force	force 🪠
forensics	forensics 🫆
forest	forest 🌲 🌳
forever	forever ♾
forgive	forgive 🙇 🙇‍♂️ 🙇‍♀️
forgot	forgot 😮 😧 🙈
fork	fork 🍽 🍴
formal	formal 🤵 🤵‍♂️ 🤵‍♀️ 🎩
fortune	fortune 🥠 🔮 🪬 🔯
forward	forward ⏩
fosho	fosho 👌
fountain	fountain ⛲ 🖋
four	four 🍀 🕓 🕟 4️⃣
four-leaf	four-leaf 🍀
four-thirty	four-thirty 🕟
fowl	fowl 🪿
fox	fox 🦊
frame	frame 🖼 🪟
framed	framed 🖼
frames	frames 🎞
france	france 🇫🇷
frankfurter	frankfurter 🌭
free	free 🆓 🈶 🈚
freedom	freedom ⛓️‍💥
freestyle	freestyle 🏊 🏊‍♂️ 🏊‍♀️
freezing	freezing 🥶
french	french 🥐 🥖 🍟
frenchguiana	frenchguiana 🇬🇫
frenchpolynesia	frenchpolynesia 🇵🇫
frenchsouthernterritories	frenchsouthernterritories 🇹🇫
fresh	fresh 💈 🪟
fried	fried 🍤
friend	friend 👥
friends	friends 🧑‍🤝‍🧑 👭 👫 👬 👥
friendship	friendship 🫂
fries	fries 🍟
frog	frog 🐸
front	front 🚪
front-facing	front-facing 🐥
frostbite	frostbite 🥶
frown	frown 😕 🙁 ☹ 😦 🙍 🙍‍♂️ 🙍‍♀️ 🙎 🙎‍♂️ 🙎‍♀️
frowning	frowning 🙁 ☹ 😦 🙍 🙍‍♂️ 🙍‍♀️
fruit	fruit 🍇 🍈 🍉 🍊 🍋 🍋‍🟩 🍌 🍍 🥭 🍎 🍏 🍐 🍑 🍒 🍓 🫐 🥝 🍅 🥑 🥧
frustrated	frustrated 🫤 😖 😠 🙍 🙍‍♂️ 🙍‍♀️
frustration	frustration 🫤
fry	fry 🍳
frying	frying 🍳
fuel	fuel ⛽
fuelpump	fuelpump ⛽
fuji	fuji 🗻
full	full 😋 💯 🫃 🫄 🌕 🌝
fume	fume 😤
fuming	fuming 😤
funeral	funeral ⚱
fungi	fungi 🍄‍🟫
fungus	fungus 🍄 🍄‍🟫
funny	funny 🤣 😂 😜
furious	furious 😤
fury	fury 😤
futbol	futbol ⚽
futuna	futuna 🇼🇫
future	future 🔮
g2g	g2g 👋
gabon	gabon 🇬🇦
gaggle	gaggle 🪿
gains	gains 💪
gait	gait 🚶 🚶‍♂️ 🚶‍♀️ 🚶‍➡️ 🚶‍♀️‍➡️ 🚶‍♂️‍➡️
gambia	gambia 🇬🇲
gamble	gamble 🎰
gambling	gambling 🎰
game	game 👾 🏐 🎳 🏏 🏑 🏒 🏓 🏸 🥌 🎯 🎱 🎮 🕹 🎰 🎲 ♠ ♥ ♦ ♣ 🃏 🀄 🎴 🏁
gamer	gamer 👾
games	games 👾
gander	gander 🪿
gang	gang 🚲
garbage	garbage 🗑
garden	garden 🐌 🐛 🐜 🐞 🫜 🏡 👒 🪏
gardener	gardener 🧑‍🌾 👨‍🌾 👩‍🌾
garlic	garlic 🧄
garnish	garnish 🍋‍🟩
gas	gas ⛽
gasoline	gasoline ⛽
gasp	gasp 🫢 😮‍💨
gay	gay 🌈 🏳️‍🌈
gear	gear ⚙
geek	geek 🤓
geese	geese 🪿
geez	geez 😳
gem	gem 💎
gemini	gemini ♊
genderqueer	genderqueer 🌈 🏳️‍🌈
gene	gene 🧬
genetics	genetics 🧬
genie	genie 🧞 🧞‍♂️ 🧞‍♀️
geometric	geometric 🔴 🔵 ⚫ ⚪ ⬛ ⬜ ◼ ◻ ◾ ◽ ▪ ▫ 🔶 🔷 🔸 🔹 🔺 🔻 💠 🔘 🔳 🔲
georgia	georgia 🇬🇪
germany	germany 🇩🇪
germs	germs 😷
gesture	gesture 🙈 🙉 🙊 🤌 🤟 🙌 🙏 🙍 🙍‍♂️ 🙍‍♀️ 🙅 🙅‍♂️ 🙅‍♀️ 🙆 🙆‍♂️ 🙆‍♀️ 🙋 🙋‍♂️ 🙋‍♀️ 🧏 🧏‍♂️ 🧏‍♀️ 🙇 🙇‍♂️ 🙇‍♀️
gesturing	gesturing 🙆 🙆‍♂️ 🙆‍♀️
gesundheit	gesundheit 🤧
getting	getting 💆 💆‍♂️ 💆‍♀️
ghana	ghana 🇬🇭
ghost	ghost 👻
gibbous	gibbous 🌔 🌖
gibraltar	gibraltar 🇬🇮
gift	gift 🧧 🎁
gifted	gifted 🤓
giggle	giggle 🤭
giggling	giggling 🤭
ginger	ginger 🦰 🫚
giraffe	giraffe 🦒
girl	girl 👧 👨‍👩‍👧 👨‍👩‍👧‍👦 👨‍👩‍👧‍👧 👨‍👨‍👧 👨‍👨‍👧‍👦 👨‍👨‍👧‍👧 👩‍👩‍👧 👩‍👩‍👧‍👦 👩‍👩‍👧‍👧
girls	girls 👭
glad	glad 😊 🥲
glass	glass 🥛 🍷 🍸 🥂 🥃 🫗 🔍 🔎
glasses	glasses 🥸 🤓 🥂 👓 🕶
glbt	glbt 🌈 🏳️‍🌈
glbtq	glbtq 🌈 🏳️‍🌈
glitter	glitter 🪩
glittery	glittery 🌟
globe	globe 🌍 🌎 🌏 🌐
glory	glory 🐦‍🔥
glove	glove 🥎 🥊
gloves	gloves 🧤
glow	glow 🌟
glowing	glowing 🌟
go	go 💨
goal	goal 🥍 🥅
goat	goat 🐐 ♑
gobble	gobble 🦃
goblin	goblin 👺
goggles	goggles 🥽
gold	gold 🏅 🥇 💰 🪙
golf	golf 🏌 🏌️‍♂️ 🏌️‍♀️ ⛳ 🚩
golfing	golfing 🏌 🏌️‍♂️ 🏌️‍♀️
gondola	gondola 🚠 🚡
gone	gone 💨
goo	goo 👶
good	good 🫡 😪 😴 💖 💤 👍 👎 👏 🦸 🦸‍♂️ 🦸‍♀️ 🛌 🧧
goodbye	goodbye 🫂
goodnight	goodnight 😴 🥱 💤 🛌
goofy	goofy 🤪
googly	googly 👀
goose	goose 🪿
gordita	gordita 🫓
gorilla	gorilla 🦍
gossip	gossip 💁 💁‍♂️ 💁‍♀️
got	got 👌
gotcha	gotcha 👌
gotta	gotta 💨
grade	grade 🈴
graduate	graduate 🧑‍🎓 👨‍🎓 👩‍🎓
graduation	graduation 🎓
grain	grain 🌾 🍞
grains	grains 🌾
gramps	gramps 👴
grandchild	grandchild 🧒
granddaughter	granddaughter 👧
grandfather	grandfather 👴
grandma	grandma 👵
grandmother	grandmother 👵
grandpa	grandpa 👴
grandparent	grandparent 🧓
grandson	grandson 👦
granny	granny 👵
grape	grape 🍇
grapes	grapes 🍇
graph	graph 💹 📈 📉 📊
grapple	grapple 🤼 🤼‍♂️ 🤼‍♀️
grasshopper	grasshopper 🦗
grateful	grateful 🥲 🥹
gratitude	gratitude 🥹
grave	grave 🪦
graveyard	graveyard 🪦
gray	gray 🩶 🦳
great	great 👏
greece	greece 🇬🇷
green	green 💚 🏌 🏌️‍♂️ 🏌️‍♀️ 🌳 🍏 🥬 🥗 📗 🔰 🟢 🟩
greenland	greenland 🇬🇱
greetings	greetings 👋
grenada	grenada 🇬🇩
grenadines	grenadines 🇻🇨
grey	grey 🩶
grimace	grimace 😬 🙎 🙎‍♂️ 🙎‍♀️
grimacing	grimacing 😬
grin	grin 😀 😃 😄 😁 😸
grinning	grinning 😀 😃 😄 😁 😆 😅 🤩 😬 😺 😸
grizzly	grizzly 🐻
groan	groan 😮‍💨
groom	groom 🤵‍♂️ 💇 💇‍♂️ 💇‍♀️ 🪮
groove	groove 💃 🕺
gross	gross 😝 🤢 🤮
ground	ground ⛱
grow	grow 🪴
growing	growing 💗
growl	growl 🐻
growth	growth 🌷 💹 📈
gtg	gtg 👋
gua	gua 👲
guadeloupe	guadeloupe 🇬🇵
guam	guam 🇬🇺
guanaco	guanaco 🦙
guapi	guapi 👲
guard	guard 😦 💂 💂‍♂️ 💂‍♀️
guatemala	guatemala 🇬🇹
guernsey	guernsey 🇬🇬
guess	guess 🤷 🤷‍♂️ 🤷‍♀️
guide	guide 🦮 🪬
guinea	guinea 🇬🇳
guinea-bissau	guinea-bissau 🇬🇼
guitar	guitar 🎸
gun	gun 🔫
guyana	guyana 🇬🇾
gym	gym 💪
gymnastics	gymnastics 🤸 🤸‍♂️ 🤸‍♀️
gyro	gyro 🥙
gyōza	gyōza 🥟
habitat	habitat 🌳
haha	haha 😆 🤣 😂 🫠
hahaha	hahaha 😆
hail	hail 🚖
hair	hair 👱‍♀️ 👱‍♂️ 💇 💇‍♂️ 💇‍♀️ 🦰 🦱 🦳 🦲 🪮
haircut	haircut 💇 💇‍♂️ 💇‍♀️ 💈
hairless	hairless 🦲
haiti	haiti 🇭🇹
hajj	hajj 🕋
halloween	halloween 👻 🧛 🧛‍♂️ 🧛‍♀️ 🧟 🧟‍♂️ 🧟‍♀️ 🐈‍⬛ 🍫 🍬 🎃
halo	halo 😇
halt	halt 🫷 🫸
hamam	hamam 🧖
hamburger	hamburger 🍔
hammer	hammer 🔨 ⛏ ⚒ 🛠
hamsa	hamsa 🪬
hamster	hamster 🐹
hand	hand 🤭 🫢 👋 🤚 🖐 ✋ 🖖 🫱 🫲 🫳 🫴 🫷 🫸 👌 🤌 🤏 ✌ 🤞 🫰 🤟 🤘 🤙 👈 👉 👆 🖕 👇 ☝ 🫵 👍 👎 ✊ 👊 👏 🙌 👐 🤝 🙏 ✍ 🙅 🙅‍♂️ 🙅‍♀️ 🙆 🙆‍♂️ 🙆‍♀️ 💁 💁‍♂️ 💁‍♀️ 🙋 🙋‍♂️ 🙋‍♀️ 🧑‍🤝‍🧑 👭 👫 👬 🧤 🪭 🪬
handbag	handbag 👛 👜 👝
handball	handball 🤾 🤾‍♂️ 🤾‍♀️
handgun	handgun 🔫
handicap	handicap ♿
handle	handle 🤹 🤹‍♂️ 🤹‍♀️ 🍵
hands	hands 🤗 🖖 🙌 🫶 👐 🤲
handshake	handshake 🫱 🫲 🤝
handy	handy 🪛
hang	hang 🤙
hang-glide	hang-glide 🪂
hanukkah	hanukkah 🕎
happy	happy 😀 😃 😄 😁 😆 🤣 😂 🙂 😇 ☺ 🥲 🥳 🤸 🤸‍♂️ 🤸‍♀️ 🎂
hard	hard 🦻
hardhat	hardhat 👷 👷‍♂️ 👷‍♀️
harp	harp 🪉
hashi	hashi 🥢
hat	hat 🤠 🥳 👷 👷‍♂️ 👷‍♀️ 👲 👒 🎩 🎓 🧢 ⛑
hatchet	hatchet 🪓
hatching	hatching 🐣
hats	hats 👒
haunting	haunting 👻
head	head 😶‍🌫️ 🙂‍↔️ 🙂‍↕️ 🤯 🧕 🗣
head-bandage	head-bandage 🤕
headache	headache 😣 😓 💆 💆‍♂️ 💆‍♀️
headkerchief	headkerchief 🧕
headphone	headphone 🎧
headscarf	headscarf 🧕
headstone	headstone 🪦
healing	healing ☮
health	health 🧑‍⚕️ 👨‍⚕️ 👩‍⚕️ 🍎 🫚
healthcare	healthcare 🧑‍⚕️ 👨‍⚕️ 👩‍⚕️
healthier	healthier ❤️‍🩹
hear	hear 🙉 👂 🧏 🧏‍♂️ 🧏‍♀️
heard	heard 🇭🇲
hearing	hearing 👂 🦻
heart	heart 🥰 😘 😻 💌 💘 💝 💖 💗 💓 💞 💕 💟 ❣ 💔 ❤️‍🔥 ❤️‍🩹 🩷 🧡 💛 💚 💙 🩵 💜 🤎 🖤 🩶 🤍 💋 🫰 🫶 🫀 💏 👩‍❤️‍💋‍👨 👨‍❤️‍💋‍👨 👩‍❤️‍💋‍👩 💑 👩‍❤️‍👨 👨‍❤️‍👨 👩‍❤️‍👩 🏠 🏡 ♥ 🩺
heart-eyes	heart-eyes 😍 😻
heartbeat	heartbeat 💓 🫀
heartbreaker	heartbreaker 😉
heartbroken	heartbroken 💔
hearth	hearth 💟
heartpulse	heartpulse 💗
hearts	hearts 🥰 😍 💞 💕 ♥
heat	heat 🫠 🥵 😳 🌞
heavenly	heavenly 🪽
heavy	heavy ❣ 🪨 ➖ ➗ 🟰 💲 ⭕ ✔
hedgehog	hedgehog 🦔
heel	heel 👠
heels	heels 👠
hehe	hehe 🤣 😂 🙃
helicopter	helicopter 🚁
hello	hello 👋 🫂
helmet	helmet 💂 💂‍♂️ 💂‍♀️ 🪖 ⛑
help	help 🩼 🆘
herb	herb 🌿 🫚
herd	herd 🦬
here	here 🙋 🙋‍♂️ 🙋‍♀️ 🈁
hero	hero 🦸 🦸‍♂️ 🦸‍♀️
heroine	heroine 🦸‍♀️
herzegovina	herzegovina 🇧🇦
hey	hey 👋
hi	hi 👋
hibiscus	hibiscus 🌺
hidden	hidden 🫥 🥷
hide	hide 🫣 🫥 🙈
hiding	hiding 🫣
high	high ✋ 🫷 🫸 🙏 ⚡ 🔊
high-heeled	high-heeled 👠
high-speed	high-speed 🚄 🚅
highway	highway 🛣
hijab	hijab 🧕
hike	hike 🚶 🚶‍♂️ 🚶‍♀️ 🚶‍➡️ 🚶‍♀️‍➡️ 🚶‍♂️‍➡️
hiking	hiking 🥾
hilarious	hilarious 🤣 😂
hindu	hindu 🛕 🕉
hinduism	hinduism 🪷
hinny	hinny 🫏
hippo	hippo 🦛
hippopotamus	hippopotamus 🦛
hit	hit 🎯
hitched	hitched 💒
hm	hm 😕
hmm	hmm 🤔 🤨 😒
hocho	hocho 🔪
hockey	hockey 🏑 🏒
hoist	hoist 🛗
hold	hold 🫱 🫲 🫴 🫷 🫸 🤌 🧑‍🤝‍🧑 👭 👫 👬
holding	holding 🥹
hole	hole 🕳 ⛳ 🪏
holi	holi 🫟
holiday	holiday 🎅 🤶 🧑‍🎄
hollow	hollow ⭕
hollywood	hollywood 🎥
home	home 🪹 🛖 🏚 🏠 🏡 🔨 🔧 🔩
homie	homie 😏 👏 🔝
honduras	honduras 🇭🇳
honey	honey 🐻 🦡 🐝 🍯
honeybee	honeybee 🐝
honeypot	honeypot 🍯
hongkongsarchina	hongkongsarchina 🇭🇰
honk	honk 🪿
hook	hook 🪝
hoop	hoop 🏀
hooray	hooray 🥳 🙌 🎉
horizontal	horizontal 🚥
horizontally	horizontally 🙂‍↔️
horn	horn 🥳 📯
horns	horns 😈 👿 🤘 🐏
horoscope	horoscope ♈ ♉ ♊ ♋ ♌ ♍ ♎ ♏ ♐ ♑ ♒ ♓
horrible	horrible 😝
horror	horror 🧟 🧟‍♂️ 🧟‍♀️
horse	horse 🏇 🐴 🐎 🎠
horses	horses 🐴
horseshoe	horseshoe 🧲
hospital	hospital 🏥
hot	hot 🫠 😒 🥵 😳 🌶 🌭 ☕ ♨ 🔥 🪭 💣
hotcake	hotcake 🥞
hotdog	hotdog 🌭
hotel	hotel 🛌 🏨 🏩 🛎 🛍 🛏 🛋
hotspot	hotspot 🛜
hotsprings	hotsprings ♨
hourglass	hourglass ⌛ ⏳
hours	hours 🏪 ⏳ ⏰
house	house 🪴 🛖 🏘 🏚 🏠 🏡
houses	houses 🏘
hrs	hrs ⏰
hug	hug 🤗 😒 👐 🫂
hugging	hugging 🤗 🫂
huh	huh 🤌
human	human 👱
hump	hump 🐪 🐫
hundred	hundred 💯
hungary	hungary 🇭🇺
hungry	hungry 😋 😩 🍗 🍔 🍕 🍴
hurl	hurl 🤾 🤾‍♂️ 🤾‍♀️
hurricane	hurricane 🌀
hurry	hurry 🏃 🏃‍♂️ 🏃‍♀️ 🏃‍➡️ 🏃‍♀️‍➡️ 🏃‍♂️‍➡️
hurt	hurt 🤕 🩼
hushed	hushed 😯
hut	hut 🛖
hyacinth	hyacinth 🪻
hygiene	hygiene 🪥
hypnotized	hypnotized 😵‍💫
hóngbāo	hóngbāo 🧧
i	i ℹ
ice	ice 🍦 🍧 🍨 🧊 🏒 ⛸
iceberg	iceberg 🧊
icecream	icecream 🍦
iceland	iceland 🇮🇸
icicles	icicles 🥶
id	id 🪪 🆔
idea	idea 💭 💡
identical	identical 👯 👯‍♂️ 👯‍♀️
identification	identification 🪪
identity	identity 🫆 🆔
ideograph	ideograph 🈷 🈶 🈯 🉐 🈹 🈚 🈲 🉑 🈸 🈴 🈳 ㊗ ㊙ 🈺 🈵
idk	idk 🤷 🤷‍♂️ 🤷‍♀️
ignorance	ignorance 🤷 🤷‍♂️ 🤷‍♀️
ill	ill 🤒
ily	ily 🥰 😍 😘 😗 😚 😙 😒 💘 💝 💖 💗 💓 💕 🩷 💛 💚 💙 🩵 💜 🩶 🤟
immortal	immortal 🐦‍🔥
imp	imp 👿
impressed	impressed 😳
improvement	improvement 🔨 🔧 🔩
improving	improving ❤️‍🩹
inbox	inbox 📥
incognito	incognito 🥸
incoming	incoming 📨
increasing	increasing 💹 📈
indecisive	indecisive 🧇
index	index 🫰 👈 👉 👆 👇 ☝ 🫵 🗂 📇
india	india 🇮🇳
indifference	indifference 🤷 🤷‍♂️ 🤷‍♀️
indigo	indigo 🪻
indonesia	indonesia 🇮🇩
industrial	industrial 🧑‍🏭 👨‍🏭 👩‍🏭
inexpressive	inexpressive 😑
infant	infant 👶 🍼
infinity	infinity ♾
information	information ℹ
inhalation	inhalation 🫁
injured	injured 🩼
injury	injury 🤕 🩸
ink	ink 🔏 🫟
innocent	innocent 😇
input	input 🔠 🔡 🔢 🔣 🔤
insect	insect 🦋 🐛 🐜 🐝 🪲 🐞 🦗 🪳 🕷 🦟 🪰
instructor	instructor 🧑‍🏫 👨‍🏫 👩‍🏫
instrument	instrument 🎷 🪗 🎸 🎹 🎺 🎻 🪘 🪇 🪈 🪉
intelligent	intelligent 🤓 🧠
intercardinal	intercardinal ↗ ↘ ↙ ↖
interlocking	interlocking 🧩
internet	internet 🌐 🛜
interrobang	interrobang ⁉
interrogation	interrogation 🤌
intersection	intersection 🚥 🚦
intoxicated	intoxicated 🥴
introvert	introvert 🫥
invent	invent 💭
invention	invention 💭
inventor	inventor 🧑‍💻 👨‍💻 👩‍💻
invertebrate	invertebrate 🪼
invisible	invisible 🫥
invoice	invoice 🧾
iran	iran 🇮🇷
iraq	iraq 🇮🇶
ireland	ireland 🇮🇪
irish	irish ☘ 🍀
iron	iron 🧇
ironic	ironic 😼
irritated	irritated 🙍 🙍‍♂️ 🙍‍♀️
islam	islam 🕌 🕋 ☪
island	island 🏝
isleofman	isleofman 🇮🇲
israel	israel 🇮🇱
italy	italy 🇮🇹
i’m	i’m 💀
jack	jack 🎃
jack-o-lantern	jack-o-lantern 🎃
jacked	jacked 💪
jacket	jacket 🥼 🧥
jamaica	jamaica 🇯🇲
janmayen	janmayen 🇸🇯
japan	japan 🗾 🇯🇵
japanese	japanese 🍙 🍡 🏣 🏯 🎋 🎍 🎎 🎴 🔰 🈁 🈂 🈷 🈶 🈯 🉐 🈹 🈚 🈲 🉑 🈸 🈴 🈳 ㊗ ㊙ 🈺 🈵 🎌
jar	jar 🍯 🫙
jazz	jazz 👐
jealous	jealous 😐 😑 😒
jeans	jeans 👖
jeez	jeez 😳
jel	jel 😒
jelly	jelly 😒 🪼
jellyfish	jellyfish 🪼
jeotgarak	jeotgarak 🥢
jersey	jersey 🇯🇪
jet	jet ✈
jew	jew 🕍 ✡
jewel	jewel 💎
jewish	jewish 🕍 ✡ 🕎 🔯
jiaozi	jiaozi 🥟
jigsaw	jigsaw 🧩
jinn	jinn 🧞 🧞‍♂️ 🧞‍♀️
job	job 👏 🏢
jockey	jockey 🏇
joey	joey 🦘
joke	joke 😜
joker	joker 🃏
jolly	jolly 🏴‍☠️
jordan	jordan 🇯🇴
journey	journey 🛄
joy	joy 🤣 😂 🥲 😒 🥹 😹
joystick	joystick 🕹
judaism	judaism 🕍 ✡ 🕎 🔯
judge	judge 🧑‍⚖️ 👨‍⚖️ 👩‍⚖️
judo	judo 🥋
jug	jug 🏺
juggle	juggle 🤹 🤹‍♂️ 🤹‍♀️
juggling	juggling 🤹 🤹‍♂️ 🤹‍♀️
juice	juice 🥤 🧃
jump	jump 🦘
justice	justice 🧑‍⚖️ 👨‍⚖️ 👩‍⚖️ ♎
kaaba	kaaba 🕋
kale	kale 🥬
kangaroo	kangaroo 🦘
karaoke	karaoke 🎤
karate	karate 🥋
katakana	katakana 🈁 🈂
kazakhstan	kazakhstan 🇰🇿
kebab	kebab 🥙 🍢
keep	keep 🤐 💯
kenya	kenya 🇰🇪
kerchief	kerchief 🧕
key	key 🍋‍🟩 🔐 🔑 🗝
keyboard	keyboard 🎹 ⌨
keycap	keycap #️⃣ *️⃣ 0️⃣ 1️⃣ 2️⃣ 3️⃣ 4️⃣ 5️⃣ 6️⃣ 7️⃣ 8️⃣ 9️⃣ 🔟
keys	keys 🔑
khalsa	khalsa 🪯
khanda	khanda 🪯
kick	kick 🦵 🦶 🛴 👞 👟
kid	kid 🧒 👦 👧
kidding	kidding 😏
kidney	kidney 🫘
kimono	kimono 👘
king	king 🤴 👑
kiribati	kiribati 🇰🇮
kiss	kiss 😘 😗 😙 😽 💋 👄 🫦 💏 👩‍❤️‍💋‍👨 👨‍❤️‍💋‍👨 👩‍❤️‍💋‍👩 💑 👩‍❤️‍👨 👨‍❤️‍👨 👩‍❤️‍👩
kisses	kisses 😍 😚 😙 💝 💖 💗 💕
kissing	kissing 😚 😙 😽 💋 👄
kitchen	kitchen 🔪
kite	kite 🪁
kitten	kitten 🐱 🐈
kitty	kitty 🐱
kiwi	kiwi 🥝
knee	knee 🦵
kneel	kneel 🧎 🧎‍♂️ 🧎‍♀️ 🧎‍➡️ 🧎‍♀️‍➡️ 🧎‍♂️‍➡️
kneeling	kneeling 🧎 🧎‍♂️ 🧎‍♀️ 🧎‍➡️ 🧎‍♀️‍➡️ 🧎‍♂️‍➡️
knees	knees 🧎 🧎‍♂️ 🧎‍♀️ 🧎‍➡️ 🧎‍♀️‍➡️ 🧎‍♂️‍➡️
knife	knife 🍽 🍴 🔪 🗡
knights	knights 🐉 ⚜
knit	knit 🧶
knobs	knobs 🎛
knocked	knocked 😵
knot	knot 🪢
know	know 🫴 🙋 🙋‍♂️ 🙋‍♀️
knowledge	knowledge 📖 📚
knows	knows 🤷 🤷‍♂️ 🤷‍♀️
knuckle	knuckle 👊
koala	koala 🐨
kosovo	kosovo 🇽🇰
kuaizi	kuaizi 🥢
kuwait	kuwait 🇰🇼
kyrgyzstan	kyrgyzstan 🇰🇬
lab	lab 🥼 🔍 🔎 🧪 🧫 🔬
label	label 🏷
lacrosse	lacrosse 🥍
ladder	ladder 🪜
lady	lady 👩 👩‍🦰 👩‍🦱 👩‍🦳 👩‍🦲 👵 🐞 👚 👜
ladybird	ladybird 🐞
ladybug	ladybug 🐞
lai	lai 🧧
lake	lake 🚣 🚣‍♂️ 🚣‍♀️ 🚤
lamb	lamb 🐑
lambchop	lambchop 🥩
lamp	lamp 🧞 🧞‍♂️ 🧞‍♀️ 🪔 🛋
landing	landing 🛬
landscape	landscape 🌆
lantern	lantern 🎃 🏮
laos	laos 🇱🇦
laptop	laptop 💻
large	large 🤪 🦣 🦤 ⭕ ⬛ ⬜ 🔶 🔷
last	last 🌗 🌜 ⏮
late	late 🫩 ⏰
later	later 👋
lather	lather 🧼
latin	latin ✝ 🔠 🔡 🔤
latvia	latvia 🇱🇻
laugh	laugh 😀 😄 😆 🤣 😂 😹
laughing	laughing 😹
launch	launch 🚀
laundry	laundry 🧺
lavash	lavash 🫓
lavatory	lavatory 🚹 🚺 🚻 🚾
lavender	lavender 🪻
law	law 🧑‍⚖️ 👨‍⚖️ 👩‍⚖️ 👮 👮‍♂️ 👮‍♀️
lazy	lazy 🦥
leaf	leaf 🌿 🍀 🍁 🍂 🍃 🔰
leafless	leafless 🪾
leafy	leafy 🥬
lebanon	lebanon 🇱🇧
lecturer	lecturer 🧑‍🏫 👨‍🏫 👩‍🏫
ledger	ledger 📒
leer	leer 😏
left	left 🗨 🫲 👈 🔍 🛅 ⬅ ↩ ↪ ◀
left-facing	left-facing 🤛
left-pointing	left-pointing 🔍
left-right	left-right ↔
leftward	leftward 🫲 🫷
leftwards	leftwards 🫲 🫷 🤛
leg	leg 🦿 🦵 🍗
legged	legged 🧘 🧘‍♂️ 🧘‍♀️
legit	legit 👌
legs	legs 🧘 🧘‍♂️ 🧘‍♀️
legume	legume 🫘 🫛
lemon	lemon 🍋
leo	leo 🦁 ♌
leopard	leopard 🐆
lesbian	lesbian 🌈 🏳️‍🌈
lesotho	lesotho 🇱🇸
letter	letter 💌 ✉ 📧 📨 📩 📤 📥
letters	letters 🔠 🔡 🔤
lettuce	lettuce 🥬
let’s	let’s 💃 🕺
level	level 🎚
levitating	levitating 🕴
lgbt	lgbt 🌈 🏳️‍🌈
lgbtq	lgbtq 🌈 🏳️‍🌈
lgbtqia	lgbtqia 🌈 🏳️‍🌈
liar	liar 🤥
liberia	liberia 🇱🇷
liberty	liberty 🗽
libra	libra ⚖ ♎
library	library 📖 📗 📘 📙 📚
libya	libya 🇱🇾
license	license 🪪
lick	lick 👅
lie	lie 🤥
liechtenstein	liechtenstein 🇱🇮
life	life 🪼 🛟 🧬
lifesaver	lifesaver 🛟
lift	lift 🫴 🚠 🛗
lifter	lifter 🏋 🏋️‍♂️ 🏋️‍♀️
lifting	lifting 🏋 🏋️‍♂️ 🏋️‍♀️
light	light 🩵 🪶 🚈 🚨 🚥 🚦 🧨 🕯 💡 🔦 🏮 🪔 🔆 🏳️‍⚧️
lightning	lightning ⛈ 🌩 ⚡
like	like 🩷 🩵 👍
lilac	lilac 🪻
limb	limb 🦵
lime	lime 🍋‍🟩
line	line 🫥
link	link 🖇 🔗
linked	linked 🖇
links	links 🔗
lion	lion 🦁 🦭 ♌
lip	lip 🫦
lips	lips 💋 👄
lipstick	lipstick 👄 🫦 💄
liquid	liquid 🫠 🫗 🫟
liquor	liquor 🥃
list	list 📋
listen	listen 🙉 👂
listening	listening 👂
lit	lit 🔥
litaf	litaf 🔥
lithuania	lithuania 🇱🇹
litter	litter 🚮 🚯
litterbin	litterbin 🚮
littering	littering 🚯
little	little 🤏
lives	lives ☯
lizard	lizard 🦎
llama	llama 🦙
lmao	lmao 🤣 😂 💀
loaf	loaf 🍞
lob	lob 🤾 🤾‍♂️ 🤾‍♀️
lobster	lobster 🦞
location	location 📍
lock	lock 🔒 🔓 🔏 🔐 🔑 🗝
locked	locked 🔒 🔏 🔐
locker	locker 🛅
locomotive	locomotive 🚂
log	log 🪵
lol	lol 😄 😆 🤣 😂 🫠 😒 😹
lollipop	lollipop 🍭
london	london 💂 💂‍♂️ 💂‍♀️
lonely	lonely 💔
long	long 🪘
look	look 👀
looking	looking 👀
loop	loop ➰ ➿
loopy	loopy 😜
loose	loose 🤙
lorry	lorry 🚛
losing	losing 😔 😞
lost	lost 😔
lotion	lotion 🧴
lotrstyle	lotrstyle 🧝
lotus	lotus 🧘 🧘‍♂️ 🧘‍♀️ 🪷
loud	loud 🔊 📢
loudly	loudly 😭
loudspeaker	loudspeaker 📢
love	love 🥰 😍 😘 😗 😙 😻 💌 💘 💓 💕 ❤️‍🔥 🩷 💛 💚 💙 🩵 💜 🩶 🫰 🤟 🫶 💏 👩‍❤️‍💋‍👨 👨‍❤️‍💋‍👨 👩‍❤️‍💋‍👩 💑 👩‍❤️‍👨 👨‍❤️‍👨 👩‍❤️‍👩 🫂 💐 🌹 🏩 🪉
love-you	love-you 🤟
lover	lover 😘
loving	loving 💕
low	low 🔈 🪫 🔅
lowercase	lowercase 🔡
lowered	lowered 📪 📭
luck	luck 🫡 🤞 🧧
lucky	lucky 🍀
luge	luge 🛷
luggage	luggage 🧳 🛅
lumber	lumber 🪵 🪚
lunch	lunch 🍴
lung	lung 🫁
lungs	lungs 🫁
lupine	lupine 🪻
lure	lure 🪤
lust	lust ❤️‍🔥
luxembourg	luxembourg 🇱🇺
luxurious	luxurious 🧖 🧖‍♂️ 🧖‍♀️
luxury	luxury 🚤
lying	lying 🤥
m	m ⓜ
macaosarchina	macaosarchina 🇲🇴
machine	machine 🎰 📠
mad	mad 😖 😩 😤 😡 😠 🤬 💢 🗯 🧂 🍸
madagascar	madagascar 🇲🇬
maddening	maddening 😡 😠
mage	mage 🧙 🧙‍♂️ 🧙‍♀️
maggot	maggot 🪰
magic	magic 🧙 🧙‍♂️ 🧙‍♀️ 🧝 🧝‍♂️ 🧝‍♀️ ✨ 🔮 🪄 🎩
magical	magical 🧝 🧝‍♂️ 🧝‍♀️
magician	magician 🪄
magnet	magnet 🧲
magnetic	magnetic 🧭 🧲
magnifying	magnifying 🔍 🔎
mahjong	mahjong 🀄
mai	mai 🍹
mail	mail 💌 📧 📨 📩 📤 📥 📫 📪 📬 📭 📮
mailbox	mailbox 📫 📪 📬 📭 📮
maize	maize 🌽
major	major 🔑
makeup	makeup 💅 💄 🪞
malaria	malaria 🦟
malawi	malawi 🇲🇼
malaysia	malaysia 🇲🇾
maldives	maldives 🇲🇻
male	male 🐏 ♂
mali	mali 🇲🇱
malt	malt 🥤
malta	malta 🇲🇹
mammal	mammal 🫎 🫏
mammoth	mammoth 🦣
man	man 👨 🧔‍♂️ 👨‍🦰 👨‍🦱 👨‍🦳 👨‍🦲 👱‍♂️ 👴 🙍‍♂️ 🙎‍♂️ 🙅‍♂️ 🙆‍♂️ 💁‍♂️ 🙋‍♂️ 🧏‍♂️ 🙇‍♂️ 🤦‍♂️ 🤷‍♂️ 👨‍⚕️ 👨‍🎓 👨‍🏫 👨‍⚖️ 👨‍🌾 👨‍🍳 👨‍🔧 👨‍🏭 👨‍💼 👨‍🔬 👨‍💻 👨‍🎤 👨‍🎨 👨‍✈️ 👨‍🚀 👨‍🚒 👮‍♂️ 🕵️‍♂️ 💂‍♂️ 👷 👷‍♂️ 👷‍♀️ 👳‍♂️ 🤵‍♂️ 👰‍♂️ 🫃 👨‍🍼 🦸‍♂️ 🦹‍♂️ 🧙‍♂️ 🧚‍♂️ 🧛‍♂️ 🧝‍♂️ 🧞‍♂️ 🧟‍♂️ 💆‍♂️ 💇‍♂️ 🚶 🚶‍♂️ 🚶‍♀️ 🚶‍➡️ 🚶‍♀️‍➡️ 🚶‍♂️‍➡️ 🧍‍♂️ 🧎‍♂️ 🧎‍♂️‍➡️ 👨‍🦯 👨‍🦯‍➡️ 👨‍🦼 👨‍🦼‍➡️ 👨‍🦽 👨‍🦽‍➡️ 🏃‍♂️ 🏃‍♂️‍➡️ 🕺 🧖‍♂️ 🧗‍♂️ 🏌️‍♂️ 🏄‍♂️ 🚣‍♂️ 🏊‍♂️ 🏊‍♀️ ⛹️‍♂️ 🏋️‍♂️ 🚴‍♂️ 🚵‍♂️ 🤸‍♂️ 🤽‍♂️ 🤾‍♂️ 🤹‍♂️ 🧘‍♂️ 👫 👩‍❤️‍💋‍👨 👨‍❤️‍💋‍👨 👩‍❤️‍👨 👨‍❤️‍👨 👨‍👩‍👦 👨‍👩‍👧 👨‍👩‍👧‍👦 👨‍👩‍👦‍👦 👨‍👩‍👧‍👧 👨‍👨‍👦 👨‍👨‍👧 👨‍👨‍👧‍👦 👨‍👨‍👦‍👦 👨‍👨‍👧‍👧 ☃ ⛄ 👞 🚹
manage	manage 🤹 🤹‍♂️ 🤹‍♀️
manager	manager 🧑‍💼 👨‍💼 👩‍💼
mane	mane 🦁
mango	mango 🥭
manicure	manicure 💅
mantelpiece	mantelpiece 🕰
mantilla	mantilla 🧕
manual	manual 🧑‍🦽 🧑‍🦽‍➡️ 👨‍🦽 👨‍🦽‍➡️ 👩‍🦽 👩‍🦽‍➡️
man’s	man’s 👞
mao	mao 👲
map	map 🗺 🗾 📍
maple	maple 🍁
maracas	maracas 🪇
marathon	marathon 🏃 🏃‍♂️ 🏃‍♀️ 🏃‍➡️ 🏃‍♀️‍➡️ 🏃‍♂️‍➡️
marching	marching 🪈
margarita	margarita 🍋‍🟩
marine	marine 🪼
mark	mark ❣ 💋 📑 🔖 🔛 ‼ ⁉ ❓ ❔ ❕ ❗ ✅ ✔ ❌ ❎ 〽 ™ 🆙
marker	marker 📑
market	market 💹
married	married 💍
marshallislands	marshallislands 🇲🇭
marsupial	marsupial 🐨 🦘
martial	martial 🥋
martini	martini 🍸
martinique	martinique 🇲🇶
mary	mary 🪬
masjid	masjid 🕌
mask	mask 😷 👹 👺 🤿 🎭
massage	massage 💆 💆‍♂️ 💆‍♀️
mate	mate 🧉
math	math 📏 📐 ➖ ➗ 🟰
mathematician	mathematician 🧑‍🔬 👨‍🔬 👩‍🔬
matryoshka	matryoshka 🪆
mauritania	mauritania 🇲🇷
mauritius	mauritius 🇲🇺
maybe	maybe 🤷 🤷‍♂️ 🤷‍♀️
mayo	mayo 🪅
mayotte	mayotte 🇾🇹
maze	maze 🌽
ma’am	ma’am 🫡
mcdonaldislands	mcdonaldislands 🇭🇲
me	me 🫴 🤙 🙋 🙋‍♂️ 🙋‍♀️
mean	mean 👺
meat	meat 🍖 🥩 🥓 🥧
meatball	meatball 🧆
meatballs	meatballs 🍝
mechanic	mechanic 🧑‍🔧 👨‍🔧 👩‍🔧 🧰
mechanical	mechanical 🦾 🦿
medal	medal 🎖 🏅 🥇 🥈 🥉
media	media 📝
medical	medical 😷 🩻 ⚕
medicated	medicated 💊
medicine	medicine 😷 🏥 💉 🩸 💊 🩺 ⚕
medieval	medieval 👑
meditate	meditate 🙇 🙇‍♂️ 🙇‍♀️
meditation	meditation 🙇 🙇‍♂️ 🙇‍♀️ 🧘 🧘‍♂️ 🧘‍♀️
medium	medium ⭐ 🔉 ◼ ◻
medium-small	medium-small ◾ ◽
meeting	meeting 🤝
megaphone	megaphone 📣
meh	meh 😐 😑 🫥 😒 😕 🫤
melilla	melilla 🇪🇦
melon	melon 🍈
melt	melt 🫠
melted	melted 🫕
melting	melting 🫠
memo	memo 📝
memorial	memorial 🪦
men	men 👯‍♂️ 🤼‍♂️ 👬 🍸
mending	mending ❤️‍🩹
menorah	menorah 🕎
menstruation	menstruation 🩸
men’s	men’s 🚹
meow	meow 🐈‍⬛
mercy	mercy 🥺
meridians	meridians 🌐
mermaid	mermaid 🧜 🧜‍♀️
merman	merman 🧜 🧜‍♂️
merperson	merperson 🧜
merry	merry 🎅 🤶 🧑‍🎄
merwoman	merwoman 🧜‍♀️
mess	mess 🫟
message	message 💬
metal	metal 🪙
metro	metro 🚇
mexican	mexican 🌮 🌯 🫔
mexico	mexico 🇲🇽
mic	mic 🎙 🎤
microbe	microbe 🦠
micronesia	micronesia 🇫🇲
microphone	microphone 🎙 🎤
microscope	microscope 🔬
middle	middle 🖕
mild	mild 🤨
mildsurprise	mildsurprise 🤨
military	military 🎖 🪖
milk	milk 🐮 🐄 🐐 🍼 🥛 🧋
milky	milky 🌌
million	million 💰 💸 💲
millionaire	millionaire 🚤
mind	mind 🤯
mindblown	mindblown 🤯
minibus	minibus 🚐
minidisk	minidisk 💽
mining	mining ⛏
minus	minus ➖
miquelon	miquelon 🇵🇲
miriam	miriam 🪬
mirror	mirror 🪩 🪞
mischievous	mischievous 👿
miss	miss 😘 😢
moai	moai 🗿
mobile	mobile 📱 📲 📵 📶 📳 📴
mobility	mobility 🩼
mode	mode 📳
moisturizer	moisturizer 🧴
mojito	mojito 🍋‍🟩
moldova	moldova 🇲🇩
mollusk	mollusk 🦑
mom	mom 🤱 👩‍🍼
monaco	monaco 🇲🇨
monarch	monarch 🫅
money	money 🤑 🫰 🧧 💎 💰 🪙 💴 💵 💶 💷 💸 💳 💹 🏧 💱 💲
money-mouth	money-mouth 🤑
moneybag	moneybag 💰
mongolia	mongolia 🇲🇳
monitor	monitor 🖥
monkey	monkey 🙈 🙉 🙊 🐵 🐒 🦧
monocle	monocle 🧐
monorail	monorail 🚈 🚝
monster	monster 💀 ☠ 💩 👹 👺 👻 👽 👾 🤖 🧌
montenegro	montenegro 🇲🇪
monthly	monthly 🈷
montserrat	montserrat 🇲🇸
moo	moo 🐮 🐄
moon	moon 🥮 🌑 🌒 🌓 🌔 🌕 🌖 🌗 🌘 🌙 🌚 🌛 🌜 🌝 🎑
moose	moose 🫎
morning	morning 💖 ☕ 🌄 🌅
morocco	morocco 🇲🇦
mortar	mortar 🧱
mosque	mosque 🕌
mosquito	mosquito 🦟
mother	mother 🤱 👩‍🍼 🤶
motor	motor 🛵 🛥
motorboat	motorboat 🛥
motorcycle	motorcycle 🏍
motorized	motorized 🧑‍🦼 🧑‍🦼‍➡️ 👨‍🦼 👨‍🦼‍➡️ 👩‍🦼 👩‍🦼‍➡️
motorway	motorway 🛣
mount	mount 🗻
mountain	mountain 🧗 🧗‍♂️ 🧗‍♀️ 🚵 🚵‍♂️ 🚵‍♀️ 🏔 ⛰ 🌋 🗻 🚞 🚠
mountains	mountains 🌄
mouse	mouse 🐭 🐁 🖱 🪤
mousetrap	mousetrap 🪤
moustache	moustache 🥸
mouth	mouth 😃 😄 😆 😅 🤑 🤭 🫢 🤐 😶 🥴 🫤 😮 😦 😰 🤬 😺 👄
mouthless	mouthless 😶
move	move 🏃 🏃‍♂️ 🏃‍♀️ 🏃‍➡️ 🏃‍♀️‍➡️ 🏃‍♂️‍➡️ 🚛
movie	movie 🍿 🎥 🎞 📽 🎬 🎦
moyai	moyai 🗿
mozambique	mozambique 🇲🇿
mrs	mrs 🤶
muah	muah 😘 💗
mug	mug 🍺
mugs	mugs 🍻
mule	mule 🫏
multiplication	multiplication ✖ ❌ ❎
multiply	multiply ✖ ❌ ❎
multitask	multitask 🤹 🤹‍♂️ 🤹‍♀️
munch	munch 😱
muscle	muscle 💪
museum	museum 🖼 🎨
mushroom	mushroom 🍄 🍄‍🟫
music	music 🔊 🎼 🎵 🎶 🎙 🎚 🎛 🎤 🎷 🪗 🎸 🎹 🎺 🎻 🪕 🥁 🪇 🪈 🪉
musical	musical 🎼 🎵 🎶 🎹
muslim	muslim 🕌 🕋 ☪
mustache	mustache 🥸
mute	mute 😶 🔇 🔕
muted	muted 🔇
mwah	mwah 💏 👩‍❤️‍💋‍👨 👨‍❤️‍💋‍👨 👩‍❤️‍💋‍👩
mx	mx 🧑‍🎄
myanmarburma	myanmarburma 🇲🇲
mysterious	mysterious 👤
mystery	mystery 🫆
myth	myth 🧚 🧚‍♂️ 🧚‍♀️ 🧝 🧝‍♂️ 🧝‍♀️ 🧞 🧞‍♂️ 🧞‍♀️
mythology	mythology 🪽
naan	naan 🫓
nail	nail 💅
name	name 📛
namibia	namibia 🇳🇦
nanny	nanny 👩‍🍼 👨‍🍼 🧑‍🍼
nap	nap 😴 😫 🥱 🛌
nasty	nasty 🤢
national	national 🏞
natural	natural 🫚
nature	nature 🐌 🐝 🐞 🌵 🍄‍🟫 🌋 🗻 🌅 🌈 ⚡ 💧 🌊
nauru	nauru 🇳🇷
nauseated	nauseated 🤢
navigation	navigation 🧭
nazar	nazar 🧿
neck	neck 🧣
necklace	necklace 📿
necktie	necktie 👔
nectarine	nectarine 🍊
needle	needle 🧵 🪡 💉
negative	negative 📉 🧲
nepal	nepal 🇳🇵
neptune	neptune 🧜‍♂️
nerd	nerd 🤓
nerves	nerves 😟
nervous	nervous 😅 😟 😰 😓 💗 🫦
nest	nest 🪹 🪺
nesting	nesting 🪹 🪺 🪆
net	net ⛹ ⛹️‍♂️ ⛹️‍♀️ 🥅
netherlands	netherlands 🇳🇱
network	network 🛜
neutral	neutral 😐
nevis	nevis 🇰🇳
new	new 🗽 🌑 🌚 🆕
newborn	newborn 👶 👩‍🍼 👨‍🍼 🧑‍🍼 🐥
newcaledonia	newcaledonia 🇳🇨
news	news 📰 🗞
newspaper	newspaper 📰 🗞
newzealand	newzealand 🇳🇿
next	next ⏭
ng	ng 🆖
nib	nib ✒ 🔏
nicaragua	nicaragua 🇳🇮
nice	nice 😀 😁 😛 👏
niger	niger 🇳🇪
nigeria	nigeria 🇳🇬
night	night 😙 😪 😴 🥱 💖 💤 🛌 🌃 🌉 🌟 🌠
nine	nine 🕘 🕤 9️⃣
nine-thirty	nine-thirty 🕤
ninja	ninja 🥷
niue	niue 🇳🇺
no	no 🙂‍↔️ 🤯 😲 🙈 🙉 🙊 👎 🙅 🙅‍♂️ 🙅‍♀️ 🤦 🤦‍♂️ 🤦‍♀️ 🦲 🔕 ⛔ 🚫 🚳 🚭 🚯 🚷 📵 🔞 🈵
noble	noble 🫅
nod	nod 🙂‍↕️
non-drinking	non-drinking 🚱
non-potable	non-potable 🚱
noodle	noodle 🍜
nooo	nooo 😩
nope	nope 👎
norfolkisland	norfolkisland 🇳🇫
north	north ⬆
northeast	northeast ↗
northernmarianaislands	northernmarianaislands 🇲🇵
northkorea	northkorea 🇰🇵
northmacedonia	northmacedonia 🇲🇰
northwest	northwest ↖
norway	norway 🇳🇴
nose	nose 🥸 😤 👃 🐽 🚅
noses	noses 👃
nosey	nosey 👃
not	not 😑 😒 😕 🥺 😥 🙉 🙊 🙅 🙅‍♂️ 🙅‍♀️ 🤦 🤦‍♂️ 🤦‍♀️ ⏳ 🔕 ⛔ 🚫 🚳 🚭 🚯 🚷 📵 🔞 🈶
note	note 🎼 🎵 🎶 💴 💵 💶 💷 💸 🗒
notebook	notebook 📔 📓 📒
notepad	notepad 🗒
notes	notes 🎶 📝 📋
nothing	nothing 🫙
notice	notice 🪧
novels	novels 📖 📚
numbers	numbers 🔢
nuptials	nuptials 💒
nurse	nurse 🧑‍⚕️ 👨‍⚕️ 👩‍⚕️
nursing	nursing 🤱 👩‍🍼 👨‍🍼 🧑‍🍼
nurturing	nurturing 🪴
nut	nut 🥜 🔩
nutty	nutty 😜
ny	ny 🗽
nyc	nyc 🗽
o	o ⭕ 🅾
oar	oar 🚣 🚣‍♂️ 🚣‍♀️
oatmeal	oatmeal 🥣
oberon	oberon 🧚‍♂️
ocean	ocean 🧜 🧜‍♂️ 🧜‍♀️ 🏄 🏄‍♂️ 🏄‍♀️ 🐳 🐋 🐬 🦭 🐙 🪸 🪼 🌊
octagonal	octagonal 🛑
octoberfest	octoberfest 🍺
octopus	octopus 🐙
oden	oden 🍢
odor	odor 👃
off	off 📴 ☑
offer	offer 🫴
office	office 🧑‍💼 👨‍💼 👩‍💼 🏢 🏣 🏤 💻
officer	officer 👮 👮‍♂️ 👮‍♀️
ogre	ogre 👹
oh	oh 😐 😑 🙀 🤦 🤦‍♂️ 🤦‍♀️
oil	oil 🛢 🪔
ok	ok 🫡 👌 🙆 🙆‍♂️ 🙆‍♀️ 🆗
okay	okay 👌 🆗
oktoberfest	oktoberfest 🍺
old	old 🧓 👴 👵 🦳 📼 📇 🗝
olive	olive 🫒
om	om 🕉
oman	oman 🇴🇲
omg	omg 😝 🫢 😑 😒 🫨 😵‍💫 😮 😯 😲 🙈 👀 🙆 🙆‍♂️ 🙆‍♀️ 🤦 🤦‍♂️ 🤦‍♀️
omw	omw 👣 🔜
on!	on! 🔛
once	once 🔂
oncoming	oncoming 👊 🚍 🚔 🚖 🚘
one	one 👁 🐪 🕐 🕜 🔞 1️⃣
one-piece	one-piece 🩱 🩲
one-thirty	one-thirty 🕜
onion	onion 🧅
oolong	oolong 🍵
oops	oops 🤭 🙊 🫗
open	open 😃 😄 😆 😅 🤗 🫢 😮 😦 😰 😺 👐 📖 📬 📭 📂 🔓 🈺
opening	opening 🪟
ophiuchus	ophiuchus 🐍 ⛎
optical	optical 💽 💿 📀
orange	orange 🧡 🍊 📙 🟠 🟧 🔶 🔸
orangutan	orangutan 🦧
orchestra	orchestra 🪈 🪉
order	order 🦁
organ	organ 🫀 🫁
orienteering	orienteering 🧭
ornithology	ornithology 🐔 🐓 🐤 🐥 🐦 🐧 🕊 🦅 🦆 🦢 🦉 🦤 🦩 🦚 🦜 🐦‍⬛ 🪿
orthodox	orthodox ☦
orthoptera	orthoptera 🦗
ostentatious	ostentatious 🦚
otter	otter 🦦
ouch	ouch 🤕 🪼
out	out 😵
outbox	outbox 📤
outdoors	outdoors 🌻 🥾
outgoing	outgoing 📩
outlined	outlined ☺ ❔ ❕ 🔳
outtie	outtie 👋
over	over 🫢 👮 👮‍♂️ 👮‍♀️ 🍳 🌄
overeat	overeat 🫃 🫄
owl	owl 🦉
ox	ox 🐂 ♉
oyster	oyster 🦪 🥡
o’clock	o’clock 🕛 🕐 🕑 🕒 🕓 🕔 🕕 🕖 🕗 🕘 🕙 🕚
p	p 🅿
pace	pace 🚶 🚶‍♂️ 🚶‍♀️ 🚶‍➡️ 🚶‍♀️‍➡️ 🚶‍♂️‍➡️
package	package 📦
packing	packing 🧳 🛃 🛄
pad	pad 🗒 🗓
paddle	paddle 🚣 🚣‍♂️ 🚣‍♀️ 🏓
paella	paella 🥘
page	page 📃 📄
pager	pager 📟
paid	paid 🤑 💰
pail	pail 🥡 🪣
pain	pain 🥲
paint	paint 🫟
paintbrush	paintbrush 🖌
painter	painter 🎨
painting	painting 🖼 🎨 🖌
pair	pair 👯 👯‍♂️ 👯‍♀️
pakistan	pakistan 🇵🇰
palace	palace 💂 💂‍♂️ 💂‍♀️
palau	palau 🇵🇼
palestinianterritories	palestinianterritories 🇵🇸
palette	palette 🧑‍🎨 👨‍🎨 👩‍🎨
palm	palm 🫳 🫴 🌴 🥥 🪬
palms	palms 🤲
pamonha	pamonha 🫔
pamper	pamper 🧖 🧖‍♂️ 🧖‍♀️
pan	pan 🍳 🥘
panama	panama 🇵🇦
pancake	pancake 🥞
pancakes	pancakes 🥞
panda	panda 🐼
panic	panic 🫨
panting	panting 🥵
pants	pants 👖 🩳
paper	paper 🏮 📃 📜 📄 📰 🗞 ✂ 🗄 🧻
paperclip	paperclip 📎 🖇
paperclips	paperclips 🖇
papuanewguinea	papuanewguinea 🇵🇬
parachute	parachute 🪂
paraguay	paraguay 🇵🇾
parasail	parasail 🪂
parasite	parasite 🪱
parcel	parcel 📦
parent	parent 🧑‍🍼
park	park 🏞 🛝 🎡 🎢
parking	parking 🅿
parlor	parlor 💇 💇‍♂️ 💇‍♀️
parrot	parrot 🦜
part	part 〽
party	party 😛 😜 🥳 👯 👯‍♂️ 👯‍♀️ 🍹 🎉 🎊 🪅 🪩 👒 🪇
partying	partying 🥳 👯 👯‍♂️ 👯‍♀️
pass	pass ⛔
passenger	passenger 🛳 ⛴ 🚢
passing	passing 🈴
passport	passport 🛂
password	password 🔑
pasta	pasta 🍝
pastry	pastry 🍥 🎂 🍰 🥧
patience	patience 🤌
patrol	patrol 🚓
pause	pause 🫷 🫸 ⏯ ⏸
paw	paw 🐾
pawn	pawn ♟
paws	paws 🐾
pay	pay 💸 💳 💲
paying	paying 💰
pc	pc 💻
pea	pea 🫛
peace	peace 😌 ✌ 🧘 🧘‍♂️ 🧘‍♀️ 🕊 🪷 ☮
peaceful	peaceful 😇 ☮
peach	peach 🍑
peacock	peacock 🦚
peahen	peahen 🦚
peanut	peanut 🥜
peanuts	peanuts 🥜
pear	pear 🍐
pearl	pearl 🦪 🧋 🫧
pearly	pearly 🦷
pedestrian	pedestrian 🚶 🚶‍♂️ 🚶‍♀️ 🚶‍➡️ 🚶‍♀️‍➡️ 🚶‍♂️‍➡️ 🚸 🚷
pedestrians	pedestrians 🚷
peek	peek 🫣
peeking	peeking 🫣
peep	peep 🫣 👀
pen	pen ✒ 🖋 🖊 🔏
penalty	penalty 🟥 🟨
pencil	pencil ✏ 📝
penguin	penguin 🐧
pensive	pensive 😔
people	people 👯 👯‍♂️ 👯‍♀️ 🤼 🧑‍🤝‍🧑 👥 🫂
pepper	pepper 🌶 🫑
pepperoni	pepperoni 🍕
percussion	percussion 🪇
perfect	perfect 💯
performing	performing 🎭
persevere	persevere 😣
persevering	persevering 😣
person	person 🥸 🧑 👱 🧔 🧑‍🦰 🧑‍🦱 🧑‍🦳 🧑‍🦲 🧓 🙍 🙎 🙅 🙆 💁 🙋 🧏 🙇 🤦 🤷 🥷 👷 🫅 👳 👲 🤵 👰 🫄 🧚 🧚‍♂️ 🧚‍♀️ 💆 💇 💇‍♂️ 💇‍♀️ 🚶 🚶‍➡️ 🧍 🧎 🧎‍➡️ 🧑‍🦯 🧑‍🦯‍➡️ 🧑‍🦼 🧑‍🦼‍➡️ 🧑‍🦽 🧑‍🦽‍➡️ 🏃 🏃‍➡️ 🕴 🧖 🧗 🤺 🏌 🏄 🏄‍♀️ 🚣 🏊 ⛹ 🏋 🚴 🚵 🤸 🤽 🤾 🤹 🧘 🛀 🛌 💏 👩‍❤️‍💋‍👨 👨‍❤️‍💋‍👨 👩‍❤️‍💋‍👩 💑 👩‍❤️‍👨 👨‍❤️‍👨 👩‍❤️‍👩
personal	personal 💻
peru	peru 🇵🇪
pest	pest 🪳 🦟 🪰
pester	pester 🦡
pet	pet 🐶 🐕 🐱 🐈 🐹 🐰 🐇
petri	petri 🧫
pga	pga 🏌 🏌️‍♂️ 🏌️‍♀️
philippines	philippines 🇵🇭
pho	pho 🍜
phoenix	phoenix 🐦‍🔥
phone	phone 🤳 📱 📲 ☎ 📞 📵 📶 📳 📴
phones	phones 📵
photo	photo 📷
physicist	physicist 🧑‍🔬 👨‍🔬 👩‍🔬
pi	pi 👲
piano	piano 🎹
piccolo	piccolo 🪈
pick	pick 🫳 🙋 🙋‍♂️ 🙋‍♀️ 🪮 ⛏ ⚒
pick-up	pick-up 🛻
picket	picket 🪧
pickle	pickle 🥒
pickup	pickup 🛻
picnic	picnic 🧺
picture	picture 🖼
pie	pie 🥧
piece	piece 🧩
pierogi	pierogi 🥟
pig	pig 🐷 🐖 🐗 🐽
pile	pile 💩
pill	pill 💊
pills	pills 💊
pilot	pilot 🧑‍✈️ 👨‍✈️ 👩‍✈️
pin	pin 📌 📍 🧷
pina	pina 🍍
pinada	pinada 🪅
pinata	pinata 🪅
pinch	pinch 👌
pinched	pinched 🤌
pinching	pinching 🤏
pine	pine 🌲 🎍
pineapple	pineapple 🍍
ping	ping 🏓
pingpong	pingpong 🏓
pink	pink 🩷 🏳️‍⚧️
pinocchio	pinocchio 🤥
pint	pint 🍺
pipe	pipe 🪈
pirate	pirate 🦜 🏴‍☠️
pisces	pisces 🐟 ♓
pissed	pissed 😒 🤬
pistol	pistol 🔫
pita	pita 🫓
pitcairnislands	pitcairnislands 🇵🇳
pitch	pitch 🤾 🤾‍♂️ 🤾‍♀️
pity	pity 🙇 🙇‍♂️ 🙇‍♀️
pixelated	pixelated 👾
pixie	pixie 🧚 🧚‍♂️ 🧚‍♀️
pizza	pizza 🍄‍🟫 🍕
piña	piña 🥥
piñata	piñata 🪅
placard	placard 🪧
place	place 🥇 🥈 🥉 🛐
plane	plane 🧑‍✈️ 👨‍✈️ 👩‍✈️ 🛩 🛫 🛬 🛄
planet	planet 🪐
plankton	plankton 🪼
plant	plant 💐 🌸 🏵 🌹 🌺 🌻 🌼 🌷 🪻 🌱 🪴 🌴 🌵 🌾 🌿 ☘ 🍀 🌰 🎍 🪏
plaque	plaque 🪧
plate	plate 🍽
play	play 🧙 🧙‍♂️ 🧙‍♀️ 🛝 ▶ ⏯
player	player ⛹ ⛹️‍♂️ ⛹️‍♀️
playful	playful 🦦
playground	playground 🛝
playing	playing 🤽 🤽‍♂️ 🤽‍♀️ 🤾 🤾‍♂️ 🤾‍♀️ 🛝 🎴
plaything	plaything 🧸
pleading	pleading 🥺
please	please 🥺 🥹 🙏
plug	plug 🔌
plumage	plumage 🪶
plumber	plumber 🧑‍🔧 👨‍🔧 👩‍🔧 🪠
plunder	plunder 🏴‍☠️
plunger	plunger 🪠
plus	plus ➕
plush	plush 🧸
pod	pod 🫛
point	point 💯 👈 👉 👆 👇 ☝ 🪝
pointed	pointed 🔺 🔻
pointing	pointing 👈 👉 👆 👇 ☝ 🫵
poke	poke 🫵
poland	poland 🇵🇱
polar	polar 🐻‍❄️
pole	pole 💈 🎣
police	police 👮 👮‍♂️ 👮‍♀️ 🚓 🚔 🚨
polish	polish 💅
polo	polo 🤽 🤽‍♂️ 🤽‍♀️
ponder	ponder 🤔
pondering	pondering 🤔
pong	pong 🏓
poo	poo 💩
poodle	poodle 🐩
pool	pool 🎱 👙
poop	poop 💩 🪠
pop	pop 🍿 🧨
popcorn	popcorn 🍿
popper	popper 🎉
popping	popping 🍾 🧨
pork	pork 🐷 🐖
porkchop	porkchop 🥩
porous	porous 🧽
porridge	porridge 🥣
portobello	portobello 🍄‍🟫
portugal	portugal 🇵🇹
poseidon	poseidon 🧜‍♂️ 🔱
position	position 🧘 🧘‍♂️ 🧘‍♀️
positive	positive 🧲
post	post 🏣 🏤 📯 🚩
postal	postal 📯
postbox	postbox 📫 📪 📬 📭 📮
pot	pot 🪴 🍲 🫕 🍯 🫖 💰
potable	potable 🚰
potassium	potassium 🍌
potato	potato 🥔 🍠
potsticker	potsticker 🥟
potted	potted 🪴
pouch	pouch 👝
poultry	poultry 🍗
pound	pound 👊 💷
pounds	pounds 💷
pour	pour 🫗
pouring	pouring 🫗
pouting	pouting 😡 😾 🙎 🙎‍♂️ 🙎‍♀️
power	power 🪫
powerlifting	powerlifting 🏋 🏋️‍♂️ 🏋️‍♀️
pppp	pppp #️⃣
praise	praise 🙌
prawn	prawn 🍤
pray	pray 🤲 🙏 🛐
prayed	prayed 👏
prayer	prayer 🤲 📿
predator	predator 🐯 🐅 🐆
pregnant	pregnant 👶 🤰 🫃 🫄
present	present 🎁
preserver	preserver 🛟
press	press 💪
pretty	pretty 🥺 🦚 🦋
pretzel	pretzel 🥨
previous	previous ⏮
pride	pride 🌈 🏳️‍🌈
prince	prince 🤴
princess	princess 👸
print	print 👣 🫆 🐾
printer	printer 🖨
prints	prints 🐾
privacy	privacy 🔏
private	private 🔒
prize	prize 🏆
probing	probing 🧑‍🦯 🧑‍🦯‍➡️ 👨‍🦯 👨‍🦯‍➡️ 👩‍🦯 👩‍🦯‍➡️
professor	professor 🧑‍🏫 👨‍🏫 👩‍🏫
prohibit	prohibit 🙅 🙅‍♂️ 🙅‍♀️
prohibited	prohibited 🙈 🙉 🙊 🔕 ⛔ 🚫 🚳 🚭 🚯 🚱 🚷 📵 🔞 🈲
projector	projector 📽
proof	proof 🧾
prophecy	prophecy 🥠
prosthetic	prosthetic 🦾 🦿
protect	protect 🪬
protection	protection 🥽 🪬
protest	protest 🪧
proud	proud 🥲 🥹 🦚
príncipe	príncipe 🇸🇹
public	public 📢
puck	puck 🧚‍♂️ 🏒
pudding	pudding 🍮
puertorico	puertorico 🇵🇷
puke	puke 🤮
pulled	pulled 👮 👮‍♂️ 👮‍♀️
pulsating	pulsating 💓
pulse	pulse 💗 💓 🫀
pump	pump ⛽
pumpkin	pumpkin 🥧 🎃
punch	punch ✊ 👊
punctuation	punctuation ❣ ‼ ⁉ ❓ ❔ ❕ ❗ 〰
punk	punk 🧷
puppies	puppies 🐶
puppy	puppy 🥺 🐶
purity	purity 🪷
purple	purple 😈 👿 💟 💜 🪻 🟣 🟪
purse	purse 👛 👜 👝
push	push 🫷 🫸
pushing	pushing 🫷 🫸
pushpin	pushpin 📌 📍
putt	putt 🏌 🏌️‍♂️ 🏌️‍♀️
puzzle	puzzle 🧩
qatar	qatar 🇶🇦
quarter	quarter 🌓 🌗 🌛 🌜
queen	queen 👸 👑
queer	queer 🌈 🏳️‍🌈
quench	quench 🧯
question	question 🙋 🙋‍♂️ 🙋‍♀️ ⁉ ❓ ❔
quick	quick 🏃 🏃‍♂️ 🏃‍♀️ 🏃‍➡️ 🏃‍♀️‍➡️ 🏃‍♂️‍➡️
quiet	quiet 🫢 🤫 🤐 😶 🙊 🔇 🔕
r	r ®
rabbit	rabbit 🐰 🐇
raccoon	raccoon 🦝
race	race 🏃 🏃‍♂️ 🏃‍♀️ 🏃‍➡️ 🏃‍♀️‍➡️ 🏃‍♂️‍➡️ 🏁
racehorse	racehorse 🏇 🐎
racing	racing 🏃 🏃‍♂️ 🏃‍♀️ 🏃‍➡️ 🏃‍♀️‍➡️ 🏃‍♂️‍➡️ 🏇 🐎 🏎 🏍 🏁
racquet	racquet 🎾 🏸
rad	rad 😎 👌
radio	radio 📻 🔘
radioactive	radioactive ☢
radish	radish 🫜
raft	raft 🚣 🚣‍♂️ 🚣‍♀️
rage	rage 😡 😠
rail	rail 🚈
railway	railway 🚂 🚃 🚄 🚅 🚆 🚈 🚉 🚞 🛤 🚟
rain	rain ⛈ 🌦 🌧 🌈 🌂 ☂ ☔ ⛱
rainbow	rainbow 🌈 🏳️‍🌈
raise	raise 🙋 🙋‍♂️ 🙋‍♀️
raised	raised 🤨 🤚 🖐 ✋ ✊ 🙌 📫 📬
raising	raising 🙌 🙋 🙋‍♂️ 🙋‍♀️
ram	ram 🐏 ♈
ramadan	ramadan 🌙 ☪
ramen	ramen 🍜
ranch	ranch 🏠 🏡
rancher	rancher 🧑‍🌾 👨‍🌾 👩‍🌾
range	range 🏌 🏌️‍♂️ 🏌️‍♀️
rat	rat 🐀
rattle	rattle 🪇
raven	raven 🐦‍⬛
rawr	rawr 🦁
rays	rays ☀
razor	razor 🪒
reach	reach 🫱 🫲
reading	reading 📖 📗 📘 📙 📚
ready	ready 🛄
real	real 🫀
realization	realization 🤭
realize	realize 💭
rebirth	rebirth 🐦‍🔥
rebound	rebound 🪃
rebuild	rebuild 👷 👷‍♂️ 👷‍♀️
receipt	receipt 🧾
receive	receive 📲 📨 📥
receiver	receiver 📞
record	record 🎥 ⏺
recorder	recorder 🪈
recovering	recovering ❤️‍🩹
recreational	recreational 🚙
recuperating	recuperating ❤️‍🩹
recycle	recycle ♻
recycling	recycling ♻
red	red 😡 ❤ 🫀 🦰 🌹 🍎 🍒 🥩 🧧 🀄 🏮 🧰 🔼 🔽 ❓ ❗ ⭕ 🔴 🟥 🔺 🔻
red-faced	red-faced 🥵
redhair	redhair 👨‍🦰 👩‍🦰 🧑‍🦰
redhead	redhead 🦰
reef	reef 🪸
reflection	reflection 🪞
reflector	reflector 🪞
refresh	refresh 🔃 🔄
refreshing	refreshing 🍋‍🟩
refuse	refuse 🫷 🫸
regal	regal 🫅
registered	registered ®
regret	regret 🙇 🙇‍♂️ 🙇‍♀️
reincarnation	reincarnation 🐦‍🔥
reinvent	reinvent 🐦‍🔥
relationship	relationship 💑 👩‍❤️‍👨 👨‍❤️‍👨 👩‍❤️‍👩
relax	relax 🤌 💆 💆‍♂️ 💆‍♀️ 🧖 🧖‍♂️ 🧖‍♀️ 🧘 🧘‍♂️ 🧘‍♀️
relaxed	relaxed ☺ 😎
relaxing	relaxing 💆 💆‍♂️ 💆‍♀️
relief	relief 😮‍💨 😌
relieved	relieved 🥲 😌 😥
religion	religion ⛪ 🕌 🕍 ⛩ 🕋 📿 🛐 🕉 ✡ ☸ ☯ ✝ ☦ ☪ 🕎 🪯
reload	reload 🔃
reminder	reminder 🎗
remodel	remodel 👷 👷‍♂️ 👷‍♀️
renewal	renewal 🐦‍🔥
repair	repair 👷 👷‍♂️ 👷‍♀️
repairs	repairs 🔨
repeat	repeat 🔁 🔂
repercussion	repercussion 🪃
reptile	reptile 🦎
rescue	rescue 🛟 ⛑
reserved	reserved 🈯
resist	resist 🥹
resort	resort ⛵
respect	respect 🫡
respiration	respiration 🫁
restaurant	restaurant 🍞 🍳 🍝 🍢 🍥 🍦 🍧 🍨 🍬 🍭 🍶 🍷 🍴 🏮
restriction	restriction 🔞
restroom	restroom 🚹 🚺 🚻 🚾
reverse	reverse ◀ ⏪
revival	revival 🐦‍🔥
revive	revive 🐦‍🔥
revolver	revolver 🔫
revolving	revolving 💞 🚨
rewind	rewind ⏪
rewindershins	rewindershins 🔄
rex	rex 🦖
rhinoceros	rhinoceros 🦏
rhythm	rhythm 🪘
ribbon	ribbon 💝 🎀 🎗
rice	rice 🌾 🍘 🍙 🍚 🍛
rich	rich 🧐 💰 🪙 💶
rickshaw	rickshaw 🛺
ride	ride 🚲
riding	riding 🏇 🚴 🚴‍♂️ 🚴‍♀️ 🚵 🚵‍♂️ 🚵‍♀️
right	right 🗯 🫱 👉 🔎 📈 ➡ ↩ ↪ ⤴ ⤵ ▶ ⏯
right-facing	right-facing 🤜
right-pointing	right-pointing 🔎
rightward	rightward 🫱 🫸
rightwards	rightwards 🫱 🫸 🤜
ring	ring 🤼 🤼‍♂️ 🤼‍♀️ 🛟 💍
ringed	ringed 🪐
ringlets	ringlets 🦱
rip	rip 🪦
ripe	ripe 🍎
ripped	ripped 💪
rise	rise 🐦‍🔥 💹
river	river 🚣 🚣‍♂️ 🚣‍♀️
roach	roach 🪳
road	road 🛣
roar	roar 🦁
roasted	roasted 🍠
robot	robot 🤖
rock	rock 👊 🧑‍🎤 👨‍🎤 👩‍🎤 🧗 🧗‍♂️ 🧗‍♀️ 🪨 🥌 🧷
rock-on	rock-on 🤘
rocket	rocket 🧑‍🚀 👨‍🚀 👩‍🚀
rockets	rockets 🚀
rockstar	rockstar 🧑‍🎤 👨‍🎤 👩‍🎤
rofl	rofl 😆 🤣 😂
roflcopter	roflcopter 🚁
roflmao	roflmao 🤣 😂
roger	roger 🏴‍☠️
roll	roll 🥐 🧻
rolled	rolled 🗞
rolled-up	rolled-up 🗞
roller	roller 🎢 🛼 🧳
rolling	rolling 🤣 🙄
rolodex	rolodex 📇
romance	romance 🥰 😍 💌 💘 💙 💋 💏 👩‍❤️‍💋‍👨 👨‍❤️‍💋‍👨 👩‍❤️‍💋‍👩 💑 👩‍❤️‍👨 👨‍❤️‍👨 👩‍❤️‍👩 💐 💒 💍 💎
romania	romania 🇷🇴
romantic	romantic 😍 😘 💚
rook	rook 🐦‍⬛
room	room 🧖 🧖‍♂️ 🧖‍♀️ 🚹 🚺
rooster	rooster 🐓
root	root 🫚 🫜
rope	rope 🪢
ropeway	ropeway 🚡
rose	rose 🌹
rosette	rosette 🏵
rotting	rotting 🪰
round	round 📍
roundhouse	roundhouse 🛖
router	router 🛜
row	row 🚣 🚣‍♂️ 🚣‍♀️
rowboat	rowboat 🚣 🚣‍♂️ 🚣‍♀️
rowing	rowing 🚣 🚣‍♂️ 🚣‍♀️
royal	royal 🫅 🤴 👸 👑
royalty	royalty 🫅 🤴 👸 👑
rub	rub 🧞 🧞‍♂️ 🧞‍♀️
rucksack	rucksack 🎒
rugby	rugby 🏉
rule	rule 📐
ruler	ruler 📏 📐
run	run 🏃 🏃‍♂️ 🏃‍♀️ 🏃‍➡️ 🏃‍♀️‍➡️ 🏃‍♂️‍➡️
rung	rung 🪜
running	running 💨 🎽 👟
rush	rush 🏃 🏃‍♂️ 🏃‍♀️ 🏃‍➡️ 🏃‍♀️‍➡️ 🏃‍♂️‍➡️
rushed	rushed 😰
russia	russia 🪆 🇷🇺
rwanda	rwanda 🇷🇼
réunion	réunion 🇷🇪
sacred	sacred ❤️‍🔥
sad	sad 😔 😪 😕 😟 🙁 ☹ 🥺 🥹 😥 😢 😭 😖 😞 😓 😩 😫 😿 💔 💧
safari	safari 🦁
safety	safety 🫆 🛟 🦺 🧷
sagittarius	sagittarius 🏹 ♐
sailboat	sailboat ⛵
sailing	sailing ⛵
sake	sake 🍶
salad	salad 🥬 🫜 🥗
salon	salon 💆 💆‍♂️ 💆‍♀️
salsa	salsa 💃 🕺 🍋‍🟩
salt	salt 🧂
salty	salty 🧂
salute	salute 🫡 🖖
saluting	saluting 🫡
samoa	samoa 🇼🇸
sand	sand ⌛ ⏳
sandal	sandal 🩴 👡
sandals	sandals 🩴
sandwich	sandwich 🥪
sanmarino	sanmarino 🇸🇲
santa	santa 🎅 🤶 🧑‍🎄
sapling	sapling 🌱
sarcasm	sarcasm 🫠 💁 💁‍♂️ 💁‍♀️
sarcastic	sarcastic 🫠 🤌 💁 💁‍♂️ 💁‍♀️
sari	sari 🥻
sark	sark 🇨🇶
sash	sash 🎽
sassy	sassy 💁 💁‍♂️ 💁‍♀️
satchel	satchel 🎒
satellite	satellite 🛰 📡
satisfied	satisfied 😊
saturn	saturn 🪐
saturnine	saturnine 🪐
sauce	sauce 🫙
saucer	saucer 🛸
saudiarabia	saudiarabia 🇸🇦
sauna	sauna 🧖 🧖‍♂️ 🧖‍♀️
sauropod	sauropod 🦕
sausage	sausage 🌭
save	save 🛟
saver	saver 🛟
savor	savor 😋
saw	saw 🪚
sax	sax 🎷
saxophone	saxophone 🎷
scale	scale 🧗 🧗‍♂️ 🧗‍♀️ ⚖
scales	scales 🧑‍⚖️ 👨‍⚖️ 👩‍⚖️ ♎
scared	scared 🫢 🫣 😦 😧 😨 😰 😱 😓 🙈
scarf	scarf 🧣
scary	scary 😦 😧 👹 👻 🧛 🧛‍♂️ 🧛‍♀️ 🧟 🧟‍♂️ 🧟‍♀️
scene	scene ⏭ ⏮
scepticism	scepticism 🤨
schmear	schmear 🥯
scholar	scholar 🎓
school	school 🏫 🚌 🎒 📼 📔 📚 📇
science	science 🦠 🔍 🔎 🧪 🔬 🔭 📡
scientist	scientist 🧑‍🔬 👨‍🔬 👩‍🔬 🥼
scissors	scissors ✂
scoop	scoop 🪏
scooter	scooter 🛵 🛴
score	score 💯 🎼
scorpio	scorpio 🦂 ♏
scorpion	scorpion 🦂 ♏
scorpius	scorpius 🦂 ♏
scotch	scotch 🥃
scotland	scotland 🏴󠁧󠁢󠁳󠁣󠁴󠁿
scowl	scowl 🙎 🙎‍♂️ 🙎‍♀️
scream	scream 😱
screamer	screamer 😱
screaming	screaming 😱
screw	screw 🪛
screwdriver	screwdriver 🪛
scroll	scroll 📜
scuba	scuba 🤿 🥽
sea	sea 🧜 🧜‍♂️ 🧜‍♀️ 🦭 🐚 🪸 🪼 ⛵
seafood	seafood 🦞 🍢
seal	seal 🦭
search	search 🔍 🔎
seat	seat 💺 🪑
second	second 🥈
secret	secret 🤭 🤐 😶 🙈 🙉 🙊 🥷 ㊙
secure	secure 🔐
security	security 🪪
see	see 👀 🧧
seedling	seedling 🌱
seeing	seeing 👀
selfie	selfie 🤳 📷
selling	selling 🪝
semi	semi 🚛
send	send 📩
senegal	senegal 🇸🇳
sent	sent 📨 📩 📤
serbia	serbia 🇷🇸
serenity	serenity 🧘 🧘‍♂️ 🧘‍♀️ 🪷
serious	serious 👔
seriously	seriously 💁 💁‍♂️ 💁‍♀️
serpent	serpent 🐍 ⛎
serve	serve 🍦
service	service 🐕‍🦺 🈂
set	set 📐
settle	settle 🏠 🏡
seven	seven 🕖 🕢 7️⃣
seven-thirty	seven-thirty 🕢
sew	sew 🪡
sewing	sewing 🧵 🪡
sexy	sexy 😉 💋 🫦
seychelles	seychelles 🇸🇨
shade	shade 😐 😏 🙄 😡 😠 😈 👿
shades	shades 😎
shadow	shadow 👤
shaka	shaka 🤙
shake	shake 🙂‍↔️ 🫱 🫲 🤝 🪇
shaker	shaker 🧂 🪇
shaking	shaking 🫨 🙂‍↔️ 🙂‍↕️
shallow	shallow 🥘
shampoo	shampoo 🧴
shamrock	shamrock ☘
shape	shape 🧲
shark	shark 🦈
sharp	sharp 🪒
shave	shave 💈 🪒
shaved	shaved 🍧
shaven	shaven 🦲
sheaf	sheaf 🌾
shears	shears 💇 💇‍♂️ 💇‍♀️
shedding	shedding 🌳
sheep	sheep 🐏 🐑
shell	shell 🐚
shellfish	shellfish 🦐
shelter	shelter 🛖
shh	shh 🤫 😒 🙉
shield	shield 🛡
shiitake	shiitake 🍄‍🟫
shine	shine 🌞
shining	shining 💫 🌟
shinkansen	shinkansen 🚄 🚅
shinto	shinto ⛩
shiny	shiny 💍
ship	ship ⚓ 🛳 🚢 🔱
shipping	shipping 📦
shirt	shirt 🎽 👔 👕 👚
shock	shock 🤭 🫢 🫨 🤦 🤦‍♂️ 🤦‍♀️
shocked	shocked 🤯 😮 😲 😱
shoe	shoe 🩴 👞 👟 🥾 🥿 👠 👡 👢
shoes	shoes 👞 👟 👠 🩰 👢
shoo	shoo 🫳
shooting	shooting 💫 🌠
shopping	shopping 👕 👖 👗 👚 👛 👜 🛍 👞 👟 👠 👢 🛒
shortcake	shortcake 🍰
shorts	shorts 🩳
shot	shot 🥃 💉
shovel	shovel 🪏
shower	shower 🚿
showing	showing 🌍 🌎 🌏
shrimp	shrimp 🦐 🍤
shrine	shrine ⛩
shroom	shroom 🍄‍🟫
shrub	shrub 🪻
shrug	shrug 🤷 🤷‍♂️ 🤷‍♀️
shrugging	shrugging 🤷 🤷‍♂️ 🤷‍♀️
shuffle	shuffle 🔀
shush	shush 🤫
shushing	shushing 🤫
shut	shut 🤐
shuttlecock	shuttlecock 🏸
shy	shy 🫣 😒 🪭
sick	sick 😷 🤒 🤢 🤮 🤧 😵 💉 💊
side	side 🍳
sierraleone	sierraleone 🇸🇱
sigh	sigh 😮‍💨
sign	sign 🤘 🛑 🪧 🏧 🚮 ☢ ☣ ♀ ♂ ✖ ➖ ➗ 🟰 💲
signal	signal 🚥 🚦 📶
sikh	sikh 🪯
sikhism	sikhism 🪯
silence	silence 😶
silent	silent 😶 🔇 🔕
silhouette	silhouette 🗣 👤 👥
silly	silly 👻 🪿
silver	silver 🩶 🥈 🪙
simple	simple 🏠 🏡
sing	sing 🎤
singapore	singapore 🇸🇬
singer	singer 🧑‍🎤 👨‍🎤 👩‍🎤
single	single 🔂
sintmaarten	sintmaarten 🇸🇽
sir	sir 🫡 😒
siren	siren 🧜 🧜‍♂️ 🧜‍♀️ 🚨
sisters	sisters 👭
sit	sit 🪑
six	six 🕕 🕡 6️⃣
six-pointed	six-pointed 🔯
six-thirty	six-thirty 🕡
skate	skate 🛹 🛼 ⛸
skateboard	skateboard 🛹
skater	skater 🛹
skates	skates 🛼
skating	skating ⛸
skeleton	skeleton 🦴 🩻
skeptic	skeptic 🤨
skeptical	skeptical 🤨 🫤
skepticism	skepticism 🤨
skewer	skewer 🍢 🍡
ski	ski ⛷ 🏂 🫕 🚠 🎿
skier	skier ⛷
skill	skill 🤹 🤹‍♂️ 🤹‍♀️
skills	skills 🥷
skis	skis 🎿
skull	skull 💀 ☠ 🩻
skullcap	skullcap 👲
skunk	skunk 🦨
sky	sky 🩵
skydive	skydive 🪂
slap	slap 🫷 🫸
slash	slash 🔕
slate	slate 🩶
slay	slay 😎 🏆
sled	sled 🛷
sledge	sledge 🛷
sleep	sleep 😪 😴 🥱 💤 🛌 🛏
sleeping	sleeping 😪 😴 💤
sleepy	sleepy 😪 🫩 😩 🥱 💤
sleigh	sleigh 🛷
sleuth	sleuth 🕵 🕵️‍♂️ 🕵️‍♀️
slice	slice 🍕 🍰 🥧
slick	slick 😏
slide	slide 😉 🛝 📐
slider	slider 🎚
sliding	sliding 🛝
slightly	slightly 🙂 🙁
slip-on	slip-on 🥿
slipper	slipper 🥿
slot	slot 🎰
sloth	sloth 🦥
slots	slots 🎰
slovakia	slovakia 🇸🇰
slovenia	slovenia 🇸🇮
slow	slow 🦥
slug	slug 🐌
slurp	slurp 👅
sly	sly 😏 😒 🥷 🦝
small	small 🤪 🤏 🦐 🫘 🛩 ▪ ▫ 🔸 🔹
smart	smart 🤓 🧠
smartphone	smartphone 🛜
smell	smell 👃 🐽
smells	smells 👃
smelly	smelly 💩
smh	smh 😒 💩 🙈 🤦 🤦‍♂️ 🤦‍♀️
smile	smile 😀 😃 😄 😁 😆 😅 🙂 🙃 😊 😇 🥰 😍 🤩 ☺ 😙 🥲 😋 😬 😎 😈 😺 😸 😻 😼
smiley	smiley 🥲 😮‍💨 😵‍💫
smiling	smiling 😀 😃 😄 😁 😆 😅 🙂 😊 😇 🥰 ☺ 😙 🥲 😋 🤗 😬 😈 😺 😸 😻
smirk	smirk 😏
smoke	smoke 😮‍💨 🚫 🚭
smoking	smoking 🚬 🚭
smooch	smooch 😘 😗
smooches	smooches 😗 😚
sms	sms 💬
smug	smug 😏
snail	snail 🐌
snake	snake 🐍 ⛎
snap	snap 🫰 📷
snapdragon	snapdragon 🪻
snare	snare 🪤
sneaker	sneaker 👟
sneeze	sneeze 🤧 😫
sneezing	sneezing 🤧
snicker	snicker 😏
snorkeling	snorkeling 🤿
snout	snout 🐽
snow	snow ⛷ 🏂 🏔 🌨 ❄ ☃ ⛄ 🎿 🛷 🪏
snow-capped	snow-capped 🏔
snowboard	snowboard 🏂
snowboarder	snowboarder 🏂
snowflake	snowflake ❄
snowman	snowman ☃ ⛄
soak	soak 🧽
soap	soap 🧼 🫧
soapdish	soapdish 🧼
soar	soar 🪽 🪁
sob	sob 😭
soccer	soccer ⚽
socks	socks 🧦
soda	soda 🥤
soft	soft 🍦 🥤 🔈
softball	softball 🥎
softdrink	softdrink 🥤
software	software 🧑‍💻 👨‍💻 👩‍💻
soldier	soldier 🥷 🪖
solid	solid 🪨
solidarity	solidarity ✊
solomonislands	solomonislands 🇸🇧
somalia	somalia 🇸🇴
somersault	somersault 🤸 🤸‍♂️ 🤸‍♀️
son	son 👦
soon	soon 🔜
soothe	soothe 💆 💆‍♂️ 💆‍♀️
sorcerer	sorcerer 🧙 🧙‍♂️ 🧙‍♀️
sorceress	sorceress 🧙 🧙‍♂️ 🧙‍♀️
sorcery	sorcery 🧙 🧙‍♂️ 🧙‍♀️
sorry	sorry 😕 🙇 🙇‍♂️ 🙇‍♀️
sort	sort 🤏
sos	sos 🆘
soulmate	soulmate 👯 👯‍♂️ 👯‍♀️
sound	sound 👂 🔇 🔈 🔉 🔊 📢 📣 🔔 🔕 🎵 🎶 🎤 🎧
soup	soup 🍲 🍜
sour	sour 🍋 🍋‍🟩
south	south ⬇
southafrica	southafrica 🇿🇦
southeast	southeast ↘
southgeorgia	southgeorgia 🇬🇸
southkorea	southkorea 🇰🇷
southsandwichislands	southsandwichislands 🇬🇸
southsudan	southsudan 🇸🇸
southwest	southwest ↙
sow	sow 🐖
soybean	soybean 🫛
spa	spa 💆 💆‍♂️ 💆‍♀️ 🧖 🧖‍♂️ 🧖‍♀️
space	space 👽 👾 🧑‍🚀 👨‍🚀 👩‍🚀 🛰 🌑 🌒 🌓 🌔 🌕 🌖 🌗 🌘 🌙 🌚 🌛 ☀ 🌠 🌌 ☄
spade	spade ♠ 🪏
spaghetti	spaghetti 🍝
spain	spain 🇪🇸
spanner	spanner 🛠 🔧
spark	spark 🧨
sparkle	sparkle 💖 🌟 🎇 ✨ ❇
sparkler	sparkler 🎇
sparkles	sparkles ✨
sparkling	sparkling 💖 💍
speak	speak 🙊 🗣
speaker	speaker 🔇 🔈 🔉 🔊
speaking	speaking 🗣
special	special 🩷 🩵 🩶
speculum	speculum 🪞
speech	speech 💬 👁️‍🗨️
speechless	speechless 😶
speed	speed 🏃 🏃‍♂️ 🏃‍♀️ 🏃‍➡️ 🏃‍♀️‍➡️ 🏃‍♂️‍➡️ 🚄 🚅
speedboat	speedboat 🚤
spell	spell 🧙 🧙‍♂️ 🧙‍♀️
spew	spew 🤮
spice	spice 🫚
spider	spider 🕷 🕸
spill	spill 🫗 🫟
spin	spin 🚲
spinning	spinning 🚲
spiny	spiny 🦔
spiral	spiral 😵‍💫 🐚 🗒 🗓
spirit	spirit 😇
splashing	splashing 💦
splatter	splatter 🫟
splayed	splayed 🖐
split	split 🪓
sponge	sponge 🧽
spool	spool 🧵
spoon	spoon 🥣 🥄
spore	spore 🍄‍🟫
sport	sport 🏇 🏂 🏄 🏄‍♂️ 🏄‍♀️ 🏊 🏊‍♂️ 🏊‍♀️ 🚴 🚴‍♂️ 🚴‍♀️ 🚵 🚵‍♂️ 🚵‍♀️ 🤽 🤽‍♂️ 🤽‍♀️ 🤾 🤾‍♂️ 🤾‍♀️ 🚙 🛼 🏆 ⚽ ⚾ 🏀 🏈 🏉 🎾 🎳 ⛳ 🎣 🎿 🏁
sports	sports 🏅 🥎 🥍
sportutility	sportutility 🚙
spots	spots 🦒
spouting	spouting 🐳
spring	spring 🐝 🌸 🪻
springs	springs ♨
springtime	springtime 🌸
sprinkles	sprinkles 🧁
sprout	sprout 🌱 🍄‍🟫
spy	spy 🥸 🕵 🕵️‍♂️ 🕵️‍♀️
square	square ⏹ ❎ 🟥 🟧 🟨 🟩 🟦 🟪 🟫 ⬛ ⬜ ◼ ◻ ◾ ◽ ▪ ▫ 🔳 🔲
squeeze	squeeze 🪗
squeezebox	squeezebox 🪗
squid	squid 🦑
squinting	squinting 😆 😝
squirrel	squirrel 🐿
squirt	squirt 💦
srilanka	srilanka 🇱🇰
st.barthélemy	st.barthélemy 🇧🇱
st.helena	st.helena 🇸🇭
st.kitts	st.kitts 🇰🇳
st.lucia	st.lucia 🇱🇨
st.martin	st.martin 🇲🇫
st.pierre	st.pierre 🇵🇲
st.vincent	st.vincent 🇻🇨
stadium	stadium 🏟
staff	staff ⚕
stain	stain 🫟
stand	stand 🧍 🧍‍♂️ 🧍‍♀️
standing	standing 🧍 🧍‍♂️ 🧍‍♀️
star	star 🤩 💫 🧑‍🎤 👨‍🎤 👩‍🎤 🌃 ⭐ 🌟 🌠 ✨ ✡ ☪ 🔯 ✳ ✴ ❇ *️⃣
star-struck	star-struck 🤩
stare	stare 🫣
starry-eyed	starry-eyed 🤩
stars	stars 💫 🌃 ⭐
station	station 🚉 ⛽
statue	statue 🗽 🗿
steak	steak 🥩
stealth	stealth 🙊 🥷
steam	steam 😤 🧖 🧖‍♂️ 🧖‍♀️ 🚂
steambath	steambath 🧖 🧖‍♂️ 🧖‍♀️
steaming	steaming 🍜 ☕ ♨
steamroom	steamroom 🧖
stein	stein 🍺
step	step 🪜
stethoscope	stethoscope 🩺
stew	stew 🍲
stick	stick 🍢 🍡 🏑 🏒 🥍 🩼
stiletto	stiletto 👠
sting	sting 🪼
stinger	stinger 🪼
stink	stink 💩 🦨
stinks	stinks 💩
stinky	stinky 💩
stitches	stitches 🪡
stocking	stocking 🧦
stomp	stomp 🦶
stone	stone 🪨 🥌 💎
stoneface	stoneface 🗿
stop	stop 🖐 ✋ 🫷 🫸 🚏 🚥 🚦 🛑 ⏹
stoplight	stoplight 🚥 🚦
stopwatch	stopwatch ⏱
store	store 🫙 🏪 🏬
straight	straight 😐 😑 📏
straightedge	straightedge 📏
strat	strat 🎸
straw	straw 🥤 🧃
strawberry	strawberry 🍓
streamer	streamer 🎏
stress	stress 😅 😟
stressed	stressed 😅 😟 😧
stride	stride 🚶 🚶‍♂️ 🚶‍♀️ 🚶‍➡️ 🚶‍♀️‍➡️ 🚶‍♂️‍➡️
strike	strike 🎳
string	string 🧵
stringed	stringed 🪕
stripe	stripe 🦓
stroke	stroke 🥵
stroll	stroll 🚶 🚶‍♂️ 🚶‍♀️ 🚶‍➡️ 🚶‍♀️‍➡️ 🚶‍♂️‍➡️
strong	strong 💪 🦁
stub	stub 🎫
stubborn	stubborn 🫏
stuck-out	stuck-out 😛 😜 😝
student	student 🧑‍🎓 👨‍🎓 👩‍🎓
studio	studio 🎙
study	study 📚
stuffed	stuffed 🫄 🥙 🧸
stuffy	stuffy 🧐
stunned	stunned 😯
style	style 😎 💇 💇‍♂️ 💇‍♀️
suave	suave 😏
suburban	suburban 🏠 🏡
suburbia	suburbia 🏠 🏡
subway	subway 🚇
subzero	subzero 🥶
sucks	sucks 😔
suction	suction 🪠
sudan	sudan 🇸🇩
sudden	sudden 🤭
suddenrealization	suddenrealization 🤭
sugar	sugar 🧁
suit	suit 🕴 ♠ ♥ ♦ ♣ 🩱 🩲 🩳 👙
suitcase	suitcase 🧳
sulk	sulk 🙎 🙎‍♂️ 🙎‍♀️
summer	summer 🍺 🚤
summon	summon 🧙 🧙‍♂️ 🧙‍♀️
sun	sun 🌻 🌄 🌅 🌆 🌇 ☀ 🌞 ⛅ 🌤 🌥 🌦 ⛱
sunflower	sunflower 🌻
sunglasses	sunglasses 😎 🕶
sunny	sunny 🍳 ☀ 🌞
sunrise	sunrise 🌄 🌅
sunscreen	sunscreen 🧴
sunset	sunset 🌆 🌇
sunshine	sunshine 🌞
super	super 🏈
superhero	superhero 🦸 🦸‍♂️ 🦸‍♀️
supernatural	supernatural 🧛 🧛‍♂️ 🧛‍♀️
superpower	superpower 🦸 🦸‍♂️ 🦸‍♀️ 🦹 🦹‍♂️ 🦹‍♀️
supervillain	supervillain 🦹 🦹‍♂️ 🦹‍♀️
sure	sure 😕 👌
surf	surf 🏄 🏄‍♂️ 🏄‍♀️ 🌊
surfer	surfer 🏄 🏄‍♂️ 🏄‍♀️ 🌊
surfing	surfing 🏄 🏄‍♂️ 🏄‍♀️ 🌊
suriname	suriname 🇸🇷
surprise	surprise 🤭 🫢 🤨 🫨 😦 😧 🎁
surprised	surprised 😟 😮 😯 😱 🙀
sushi	sushi 🍣
suspension	suspension 🚟
suspicious	suspicious 😏
sutures	sutures 🪡
svalbard	svalbard 🇸🇯
swag	swag 😏 😎
swan	swan 🦢
swearing	swearing 🤬
sweat	sweat 😅 😰 😥 😓 💦 💧
sweating	sweating 🥵
sweden	sweden 🇸🇪
sweeping	sweeping 🧹
sweet	sweet 😛 🩷 👌 🍠 🍡 🍦 🍧 🍨 🍩 🍪 🎂 🍰 🧁 🍫 🍬 🍭 🍮 🍯 🧃
swell	swell 🏄 🏄‍♂️ 🏄‍♀️
swerve	swerve 👐
swim	swim 🏊 🏊‍♂️ 🏊‍♀️ 🛟 👙
swimmer	swimmer 🏊 🏊‍♂️ 🏊‍♀️
swimming	swimming 🏊 🏊‍♂️ 🏊‍♀️ 🤽 🤽‍♂️ 🤽‍♀️ 🥽
swimsuit	swimsuit 🩱 🩲 🩳
swirl	swirl 🍥
switzerland	switzerland 🇨🇭
sword	sword 🤺
swords	swords ⚔
symbol	symbol 💢 ♿ 🚼 ⚛ ☮ ⚧ ⚕ ♻ 🔰
symbols	symbols 🤬 🔣
sympathy	sympathy 😮
synagogue	synagogue 🕍
syria	syria 🇸🇾
syringe	syringe 💉
sãotomé	sãotomé 🇸🇹
t	t 🦖
t-rex	t-rex 🦖
t-shirt	t-shirt 👕
table	table 🏓
tableware	tableware 🥄
tabs	tabs 📑
tache	tache 🥸
taco	taco 🌮
tada	tada 🎉
taekwondo	taekwondo 🥋
tag	tag 🏷
tai	tai 🍹
tailoring	tailoring 🪡
taiwan	taiwan 🇹🇼
tajikistan	tajikistan 🇹🇯
takeout	takeout 🥡
taking	taking 🛀
tale	tale 😇 😈 👿 💀 👹 👺 👻 👽 👾 🤴 👸 👼 🎅 🤶 🧑‍🎄 🧚 🧚‍♂️ 🧚‍♀️ 🧌 🐲 🐉 🔮
talisman	talisman 🧿
talk	talk 💬 🦜
tamale	tamale 🫔
tanabata	tanabata 🎋
tangerine	tangerine 🍊
tangled	tangled 🪢
tango	tango 💃 🕺
tangy	tangy 🍋‍🟩
tanzania	tanzania 🇹🇿
tao	tao ☯
taoist	taoist ☯
tape	tape 📼
target	target 🎯
tash	tash 🥸
taste	taste 😝 🧂
tasty	tasty 😋
taurus	taurus 🐂 ♉
taxi	taxi 🚕 🚖
tbt	tbt 📻 📷 📹
tea	tea ☕ 🫖 🍵 🧋
teacher	teacher 🧑‍🏫 👨‍🏫 👩‍🏫
teacup	teacup 🍵
teal	teal 🩵
teapot	teapot 🫖
tear	tear 🤣 😂 🥲 😢 😭 😹 😿 💧
tear-off	tear-off 📆
tears	tears 🥹 😭 😹
tease	tease 😉
technologist	technologist 🧑‍💻 👨‍💻 👩‍💻
teddy	teddy 🧸
tee	tee 🏌 🏌️‍♂️ 🏌️‍♀️
teeth	teeth 😀 😃 😁 🥶 🦷 🧛 🧛‍♂️ 🧛‍♀️ 🦫 🪥
tegh	tegh 🪯
telephone	telephone 📱 📲 ☎ 📞 📵 📶 📳 📴
telescope	telescope 🔭
television	television 📺
tell	tell 🫴
teller	teller 🏧
temple	temple 🛕 🕍
tempura	tempura 🍤
ten	ten 🕙 🕥 🔟
ten-thirty	ten-thirty 🕥
tennis	tennis 🎾 🏓 👟
tension	tension 💆 💆‍♂️ 💆‍♀️
tent	tent ⛺ 🎪
tentacles	tentacles 🪼
tequila	tequila 🍋‍🟩
terrapin	terrapin 🐢
terrestrial	terrestrial 🛸
test	test 🧪
text	text 💬
thailand	thailand 🇹🇭
thanks	thanks 🙏 🫂
thanksgiving	thanksgiving 🦃
theater	theater 🎭
theatre	theatre 🎭
theme	theme 🛝 🎡 🎢
therapist	therapist 🧑‍⚕️ 👨‍⚕️ 👩‍⚕️
therapy	therapy 💆 💆‍♂️ 💆‍♀️
thermometer	thermometer 🤒 🌡
thespian	thespian 🎭
think	think 💭
thinking	thinking 🤔
third	third 🥉
thirty	thirty 🕧 🕜 🕝 🕞 🕟 🕠 🕡 🕢 🕣 🕤 🕥 🕦
this	this ☝
thong	thong 🩴
thongs	thongs 🩴
thoughts	thoughts 💭
thread	thread 🧵 🪡
three	three 👌 🤟 🕒 🕞 3️⃣
three-thirty	three-thirty 🕞
throw	throw 🤮 ⛹ ⛹️‍♂️ ⛹️‍♀️ 🤾 🤾‍♂️ 🤾‍♀️
thumb	thumb 🫰 👍 👎
thumbs	thumbs 👎
thunder	thunder ⛈ ⚡
thunderbolt	thunderbolt ⚡
thunderstorm	thunderstorm ⛈
thx	thx 🙏
tichel	tichel 🧕
tick	tick ✅ ☑ ✔
ticket	ticket 🎟 🎫
tickets	tickets 🎟
tie	tie 🪢 👔
tiger	tiger 🐯 🐅
tilted	tilted 🔍 🔎
timber	timber 🪵
time	time 😥 ⌛ ⌚ ⏰ ⏱ 🕰 🕛 🕧 🕐 🕜 🕑 🕝 🕒 🕞 🕓 🕟 🕔 🕠 🕕 🕗 🕣 🕘 🕤 🕥 🕚 🕦
timer	timer ⌛ ⏳ ⏲
timor-leste	timor-leste 🇹🇱
tipping	tipping 💁 💁‍♂️ 💁‍♀️
tipsy	tipsy 🥴
tire	tire 🛞
tired	tired 😪 😴 🫩 😵 😩 😫 🥱 💤 🛌
titania	titania 🧚‍♀️
tm	tm ™
tmi	tmi 🙉
toadstool	toadstool 🍄
toast	toast 🍞
tobago	tobago 🇹🇹
toboggan	toboggan 🛷
together	together 🤲 💏 👩‍❤️‍💋‍👨 👨‍❤️‍💋‍👨 👩‍❤️‍💋‍👩 💑 👩‍❤️‍👨 👨‍❤️‍👨 👩‍❤️‍👩
togo	togo 🇹🇬
toilet	toilet 🚽 🪠 🧻 🚹 🚺 🚻 🚾
toiletry	toiletry 🪥
tokelau	tokelau 🇹🇰
tokyo	tokyo 🗼
tomato	tomato 🍅
tomb	tomb 🪦
tombstone	tombstone 🪦
tonga	tonga 🇹🇴
tongue	tongue 😛 😜 😝 🥵 👅
tool	tool 🔪 🏺 ⚓ 🔥 🔫 🔮 🔍 🔎 🔦 ✂ 🔨 ⛏ ⚒ 🛠 🏹 🪚 🔧 🪛 🔩 ⚙ 🗜 ⚖ 🧰 ⚗ 🔬 🔭 💉 🔱 🔰
toolbox	toolbox 🧰
tooth	tooth 🦷 🍫 🍬
toothbrush	toothbrush 🪥
top	top 🎩 🔝
tophat	tophat 🎩
toppings	toppings 🍄‍🟫
torch	torch 🔦
tornado	tornado 🌪
tortoise	tortoise 🐢
toss	toss 🤾 🤾‍♂️ 🤾‍♀️
total	total ☯
totally	totally 😲
touched	touched 🥲
tough	tough 🪨
tournament	tournament 🤼 🤼‍♂️ 🤼‍♀️
towels	towels 🧻
tower	tower 🗼
toy	toy 🪀 🧸
trace	trace 🫆
track	track 🛤 ⏭ ⏮
trackball	trackball 🖲
tracks	tracks 🔀
tractor	tractor 🚜
trade	trade ™
trademark	trademark ™
tradesperson	tradesperson 🧑‍🔧 👨‍🔧 👩‍🔧
traffic	traffic 🚥 🚦 🚸 ⛔
train	train 🚂 🚃 🚄 🚅 🚆 🚉 🛤
trains	trains 🚂
tram	tram 🚃 🚊 🚋 🚎
tramway	tramway 🚡
trans	trans 🌈 🏳️‍🌈
transform	transform 🐦‍🔥
transgender	transgender 🌈 ⚧ 🏳️‍🌈 🏳️‍⚧️
transparent	transparent 🪟
transportation	transportation 🛻
trap	trap 🪤
trash	trash 🗑
travel	travel 🚂 🚃 🚅 🚇 🚤 🚢 ✈ 🚁 🚀 🧳 🗿 🛄
tray	tray 📤 📥
treasure	treasure 🪙 🏴‍☠️
treat	treat 🧁
treatment	treatment 💆 💆‍♂️ 💆‍♀️
tree	tree 🌲 🌳 🌴 🪾 🎄 🎋
trend	trend 💹 📈 📉
triangle	triangle 📐 ▶ ⏭ ⏯ ◀ ⏮ 🔺 🔻
triangular	triangular 📐 🚩
triathlon	triathlon 🏊 🏊‍♂️ 🏊‍♀️
trident	trident 🧜 🧜‍♂️ 🧜‍♀️ 🔱
trim	trim 🪚
trinidad	trinidad 🇹🇹
trip	trip 🚞 📷 🛄
tristandacunha	tristandacunha 🇹🇦
triste	triste 😢
triton	triton 🧜‍♂️
triumph	triumph 😤
troll	troll 👹 🧌
trolley	trolley 🚋 🚎 🛒
trolleybus	trolleybus 🚃 🚊 🚋 🚎
trolling	trolling 🧌
troops	troops 🫡
trophy	trophy 🏆
tropical	tropical 🦩 🐠 🌴 🍋‍🟩 🍍 🥭 🍹
tropics	tropics 🍹
trouble	trouble 😵‍💫
trousers	trousers 👖
truck	truck 🚒 🛻 🚚 🚛
true	true 💯
truffle	truffle 🍄‍🟫
trumpet	trumpet 🎺
trunk	trunk 🪾
truth	truth 💯
tshirt	tshirt 👕
ttfn	ttfn 👋
ttyl	ttyl 👋 👊
tub	tub 🛀
tube	tube 🧪
tuk	tuk 🛺
tulip	tulip 🌷
tumbler	tumbler 🥃
tunisia	tunisia 🇹🇳
turban	turban 👳 👳‍♂️ 👳‍♀️
turd	turd 💩
turkey	turkey 🦃 🍗
turkmenistan	turkmenistan 🇹🇲
turks	turks 🇹🇨
turn	turn 🛞
turnip	turnip 🫜
turtle	turtle 🐢
tusk	tusk 🦣
tuvalu	tuvalu 🇹🇻
tuxedo	tuxedo 🤵 🤵‍♂️ 🤵‍♀️
tv	tv 📺
twelve	twelve 🕛 🕧
twelve-thirty	twelve-thirty 🕧
twin	twin 👯 👯‍♂️ 👯‍♀️
twine	twine 🪢
twins	twins 🧑‍🤝‍🧑 👭 👫 👬 ♊
twinsies	twinsies 👯 👯‍♂️ 👯‍♀️
twist	twist 🪢
twisted	twisted 🥨
twister	twister 🌀
two	two 💕 🐫 🕑 🕝 2️⃣
two-hump	two-hump 🐫
two-thirty	two-thirty 🕝
type	type 🅰 🆎 🅱 🅾
typhoon	typhoon 🌀
typing	typing 💬
tyrannosaurus	tyrannosaurus 🦖
tyrannosaurusrex	tyrannosaurusrex 🦖
türkiye	türkiye 🇹🇷
u	u 🧲
u.s.outlyingislands	u.s.outlyingislands 🇺🇲
u.s.virginislands	u.s.virginislands 🇻🇮
ufo	ufo 👽 👾 🛸
uganda	uganda 🇺🇬
ugh	ugh 😒 🙄 🤌
ugly	ugly 🦢
uh	uh 😑
uhh	uhh 😒
ukraine	ukraine 🇺🇦
ultimate	ultimate 🥏
um	um 😋
umbrella	umbrella 🏖 🌂 ☂ ☔ ⛱
umrah	umrah 🕋
unamused	unamused 😐 😒
unbelievable	unbelievable 😮
unbounded	unbounded ♾
uncomfortable	uncomfortable 🫦
undead	undead 🧛 🧛‍♂️ 🧛‍♀️ 🧟 🧟‍♂️ 🧟‍♀️
under	under 🐨
underage	underage 🔞
underarm	underarm 🥎
undercover	undercover 👮 👮‍♂️ 👮‍♀️
underwater	underwater 🫧
underwear	underwear 🩲 🩳
uneven	uneven 🥴
unhappy	unhappy 😐 😑 😒 😧 😢 😭 😞 😩 😤 😡 😠
unicorn	unicorn 🦄
uniform	uniform 🥋
unimpressed	unimpressed 😐 😑
unitedarabemirates	unitedarabemirates 🇦🇪
unitedkingdom	unitedkingdom 🇬🇧
unitednations	unitednations 🇺🇳
unitedstates	unitedstates 🇺🇸
universal	universal ♾
unlock	unlock 🔓 🔑
unlocked	unlocked 🔓
unlucky	unlucky 🐈‍⬛
unreal	unreal 😮
unsure	unsure 🫤
unwind	unwind 🧖 🧖‍♂️ 🧖‍♀️
up	up 🤮 🫳 👆 ☝ 👍 🤲 🧗 🧗‍♂️ 🧗‍♀️ 🍳 🧣 🧥 📄 📈 ⬆ ⤴ 🔝 🔼 ⏫ 🆙 🔺
up!	up! 🆙
up-down	up-down ↕
up-left	up-left ↖
up-right	up-right ↗
uppercase	uppercase 🔠
upset	upset 😡 😠 💢 🙍 🙍‍♂️ 🙍‍♀️ 🙎 🙎‍♂️ 🙎‍♀️ 🧂
upside-down	upside-down 🙃
upward	upward 💹 📈
upwards	upwards 🔼
urn	urn ⚱
uruguay	uruguay 🇺🇾
utility	utility 🚙
uzbekistan	uzbekistan 🇺🇿
v	v ✌
vacancy	vacancy 🈳 🈵
vaccination	vaccination 💉
valentine	valentine 💌 💘 💝 🌹
vampire	vampire 🧛 🧛‍♂️ 🧛‍♀️ 🦇 ⚰
van	van 🚐
vanuatu	vanuatu 🇻🇺
vat	vat 🪣
vaticancity	vaticancity 🇻🇦
vcr	vcr 📼
vegetable	vegetable 🍅 🍆 🥔 🥕 🫑 🥒 🥜 🫛 🍄‍🟫 🫜
vegetarian	vegetarian 🍄‍🟫 🫜
veggie	veggie 🫛 🍄‍🟫
vehicle	vehicle 🚝 🚌 🚐 🚑 🚕 🚗 🚘 🚙 🚚 🚛 🚜 🛞 🚁
veil	veil 👰 👰‍♂️ 👰‍♀️
venezuela	venezuela 🇻🇪
versus	versus 🆚
vertical	vertical 🚦 🔃 ⏸
vertically	vertically 🙂‍↕️
vest	vest 🦺
vhs	vhs 📼
vibrate	vibrate 🫨
vibration	vibration 📳
vice	vice 🗜
victory	victory ✌ 🏆
vicuña	vicuña 🦙
video	video 🎮 🕹 📻 📽 📺 📷 📸 📹 📼
videocassette	videocassette 📼
videogame	videogame 🕹
vietnam	vietnam 🇻🇳
view	view 🪟
viewer	viewer 🫵
viewing	viewing 🎑
villain	villain 🦹 🦹‍♂️ 🦹‍♀️
violet	violet 🪻
violin	violin 🎻
virgo	virgo 👧 ♍
virus	virus 🦟 🦠
vitamin	vitamin 🍊 💊
voip	voip 📞
volcano	volcano 🌋
volleyball	volleyball 🏐
voltage	voltage ⚡
volume	volume 🔈 🔉 🔊
vomit	vomit 🤢 🤮
vomiting	vomiting 🤮
vs	vs 🆚
vu	vu 🔄
vulcan	vulcan 🖖
wacky	wacky 😜
waffle	waffle 🧇
wait	wait 🫷 🫸
waiting	waiting ⏳ ⏰
wales	wales 🏴󠁧󠁢󠁷󠁬󠁳󠁿
walk	walk 🚶 🚶‍♂️ 🚶‍♀️ 🚶‍➡️ 🚶‍♀️‍➡️ 🚶‍♂️‍➡️ 👣
walking	walking 🧟 🧟‍♂️ 🧟‍♀️ 🚶 🚶‍♂️ 🚶‍♀️ 🚶‍➡️ 🚶‍♀️‍➡️ 🚶‍♂️‍➡️
wall	wall 🧱
wallis	wallis 🇼🇫
wand	wand 🪄
waning	waning 🌖 🌘
war	war 🥷 🪖
warning	warning ⚠
warrior	warrior 🪖
waste	waste 🗑
wastebasket	wastebasket 🗑
watch	watch 🙈 ⌚
water	water 💦 🤽 🤽‍♂️ 🤽‍♀️ 🐃 🫗 🥤 💧 🌊 🔫 🚿 🚰 🚾 🚱 ♒
watermelon	watermelon 🍉
waterpolo	waterpolo 🤽 🤽‍♂️ 🤽‍♀️
wave	wave 👋 🌊
waves	waves 🏄 🏄‍♂️ 🏄‍♀️
waving	waving 🏴 🏳
wavy	wavy 🥴 〰
waxing	waxing 🌒 🌔
way	way 🤯 😲 🌌
wc	wc 🚹 🚺 🚻 🚾
wealthy	wealthy 🧐
weapon	weapon 🔪 🏺 🔫 🗡 ⚔ 🪃 🏹 🛡
wearing	wearing 👳 👳‍♂️ 👳‍♀️
weary	weary 🫩 😩 🙀
weather	weather 🌡 ☀ 🌞 ☁ ⛅ 🌤 🌥 🌦 🌧 🌨 🌩 🌪 🌫 🌀 🌈 ☔ ❄ 💧
web	web 🕸 🌐
wedding	wedding 🤵 🤵‍♂️ 🤵‍♀️ 👰 👰‍♂️ 👰‍♀️ 💒 💍 💎
wedge	wedge 🧀
weekend	weekend 👕 👖
weight	weight 🏋 🏋️‍♂️ 🏋️‍♀️ ⚖
weightlift	weightlift 💪
weightlifter	weightlifter 🏋 🏋️‍♂️ 🏋️‍♀️
weights	weights 🏋 🏋️‍♂️ 🏋️‍♀️
weird	weird 😒
weirdo	weirdo 😜
welding	welding 🥽
well	well ❤️‍🩹 👏
west	west ⬅
westernsahara	westernsahara 🇪🇭
wet	wet 💦
whale	whale 🐳 🐋
what	what 🤨 😳 😦 😧 🤌
whatever	whatever 😝 😐 😑 🫥 😒 🙄 😴 🫤 🥱 💅 💁 💁‍♂️ 💁‍♀️ 🤷 🤷‍♂️ 🤷‍♀️
wheat	wheat 🍞
wheel	wheel 🎡 🛞 ☸
wheelchair	wheelchair 🧑‍🦼 🧑‍🦼‍➡️ 👨‍🦼 👨‍🦼‍➡️ 👩‍🦼 👩‍🦼‍➡️ 🧑‍🦽 🧑‍🦽‍➡️ 👨‍🦽 👨‍🦽‍➡️ 👩‍🦽 👩‍🦽‍➡️ ♿
wheels	wheels 🛹
where	where 🏠 🏡
whew	whew 😥
whine	whine 🙎 🙎‍♂️ 🙎‍♀️
whirlwind	whirlwind 🌪
whiskers	whiskers 🧔 🧔‍♂️ 🧔‍♀️
whiskey	whiskey 🥃
whisky	whisky 🥃
whisper	whisper 😮‍💨
whistle	whistle 😮‍💨
white	white 💟 🤍 🦷 🧑‍🦯 🧑‍🦯‍➡️ 👨‍🦯 👨‍🦯‍➡️ 👩‍🦯 👩‍🦯‍➡️ 🦳 🐻‍❄️ 💮 ⭐ 🥼 ❔ ❕ ⚪ ⬜ ◻ ◽ ▫ 🔳 🏳 🏳️‍⚧️
white-collar	white-collar 🧑‍💼 👨‍💼 👩‍💼
whitehair	whitehair 👨‍🦳 👩‍🦳 🧑‍🦳
who	who 🤷 🤷‍♂️ 🤷‍♀️
whoa	whoa 🫨 😵‍💫 😮 😯
whoops	whoops 🤭
why	why 🥺
wi-fi	wi-fi 🛜
wicked	wicked 🖤
wifi	wifi 🛜
wild	wild 🥦
wildcard	wildcard 🃏
wilted	wilted 🥀
win	win 😎 🌟 🏆 👑 💰 🏁
wind	wind 🍃 🌬 🎐
window	window 🪟
wine	wine 🍷
wing	wing 🪽
wings	wings 🧚 🧚‍♂️ 🧚‍♀️ 💸
wink	wink 😉 😜
winking	winking 😉 😜
winks	winks 😉
winner	winner 🏅
winning	winning 🏆
winter	winter 🪾
wireless	wireless 🛜
wise	wise 🧓 👴 👵 🦉
wisent	wisent 🦬
wish	wish 🤲
wishbone	wishbone 🦴
wishes	wishes 🧞 🧞‍♂️ 🧞‍♀️
witch	witch 🧙 🧙‍♂️ 🧙‍♀️ 🪄 🧹
witness	witness 👁️‍🗨️
wizard	wizard 🧙 🧙‍♂️ 🧙‍♀️ 🪄
wlan	wlan 🛜
woah	woah 😵‍💫 😯 😱
wolf	wolf 🐺
woman	woman 🧔‍♀️ 👩 👩‍🦰 👩‍🦱 👩‍🦳 👩‍🦲 👱‍♀️ 👵 🙍‍♀️ 🙎‍♀️ 🙅‍♀️ 🙆‍♀️ 💁‍♀️ 🙋‍♀️ 🧏‍♀️ 🙇‍♀️ 🤦‍♀️ 🤷‍♀️ 👩‍⚕️ 👩‍🎓 👩‍🏫 👩‍⚖️ 👩‍🌾 👩‍🍳 👩‍🔧 👩‍🏭 👩‍💼 👩‍🔬 👩‍💻 👩‍🎤 👩‍🎨 👩‍✈️ 👩‍🚀 👩‍🚒 👮‍♀️ 🕵️‍♀️ 💂‍♀️ 👷‍♀️ 👳‍♀️ 🧕 🤵‍♀️ 👰‍♀️ 🤰 🤱 👩‍🍼 🦸‍♀️ 🦹‍♀️ 🧙‍♀️ 🧚‍♀️ 🧛‍♀️ 🧝‍♀️ 🧞‍♀️ 🧟‍♀️ 💆‍♀️ 💇‍♀️ 🚶‍♀️ 🚶‍♀️‍➡️ 🧍‍♀️ 🧎‍♀️ 🧎‍♀️‍➡️ 👩‍🦯 👩‍🦯‍➡️ 👩‍🦼 👩‍🦼‍➡️ 👩‍🦽 👩‍🦽‍➡️ 🏃‍♀️ 🏃‍♀️‍➡️ 💃 🧖‍♀️ 🧗‍♀️ 🏌️‍♀️ 🚣‍♀️ ⛹️‍♀️ 🏋️‍♀️ 🚴‍♀️ 🚵‍♀️ 🤸‍♀️ 🤽‍♀️ 🤾‍♀️ 🤹‍♀️ 🧘‍♀️ 👫 👩‍❤️‍💋‍👨 👩‍❤️‍💋‍👩 👩‍❤️‍👨 👩‍❤️‍👩 👨‍👩‍👦 👨‍👩‍👧 👨‍👩‍👧‍👦 👨‍👩‍👦‍👦 👨‍👩‍👧‍👧 👩‍👩‍👦 👩‍👩‍👧 👩‍👩‍👧‍👦 👩‍👩‍👦‍👦 👩‍👩‍👧‍👧 👚 👠 👡 👢 👒 🚺
woman’s	woman’s 👚 👡 👢 👒
women	women 👯‍♀️ 🤼‍♀️ 👭
women’s	women’s 🚺
won	won 😤
wonder	wonder 💭
wondering	wondering 🤔
wood	wood 🪾 🪵 🪓
woodwind	woodwind 🪈
woohoo	woohoo 🎉 🎊
wool	wool 🐑 🦙
wooly	wooly 🦣
woozy	woozy 🥴 😵‍💫
work	work 💦 👷 👷‍♂️ 👷‍♀️
worker	worker 🧑‍⚕️ 👨‍⚕️ 👩‍⚕️ 🧑‍🏭 👨‍🏭 👩‍🏭 🧑‍💼 👨‍💼 👩‍💼 👷 👷‍♂️ 👷‍♀️
worker’s	worker’s ⛑
workout	workout 💦 🏋 🏋️‍♂️ 🏋️‍♀️
world	world 🌍 🌎 🌏 🌐 🗺
worldwide	worldwide 🌐
worm	worm 🪱
worried	worried 😟 😨 🫦
worry	worry 😟 🫦
worship	worship 🛐
wow	wow 🤩 😒 🫨 😮 😳 😦 😧
wrap	wrap 🌯
wrapped	wrapped 🫔 🎁
wrapper	wrapper 🍬
wrench	wrench 🛠 🔧
wrestle	wrestle 🤼 🤼‍♂️ 🤼‍♀️
wrestling	wrestling 🤼 🤼‍♂️ 🤼‍♀️
write	write ✍
writing	writing ✍ 📔
wry	wry 😼
wtv	wtv 🫥 😒 🫤
x	x ✖ ❌ ❎
x-ray	x-ray 🩻
xmas	xmas 🎅 🤶 🧑‍🎄
xoxo	xoxo 😍 😘 😗 😚 💝 💖 💗 💕 💏 👩‍❤️‍💋‍👨 👨‍❤️‍💋‍👨 👩‍❤️‍💋‍👩
xray	xray 🩻
yacht	yacht ⛵
yang	yang ☯
yarn	yarn 🧶
yawn	yawn 😴 🥱
yawning	yawning 🥱
yay	yay 😃 😒 👏
yellow	yellow 💛 🚕 🚖 🔰 🟡 🟨
yemen	yemen 🇾🇪
yen	yen 💴 💹
yes	yes 🫡 😒 🙂‍↕️ 👍
yikes	yikes 😰 😓
yin	yin ☯
yinyang	yinyang ☯
yo	yo 👋
yo-yo	yo-yo 🪀
yoga	yoga 🧘 🧘‍♂️ 🧘‍♀️
yogi	yogi 🧘 🧘‍♂️ 🧘‍♀️
yolo	yolo 😜 😝 💀 ⏳ 🎆
york	york 🗽
you	you 🥰 😘 😗 😒 😮 👋 🤟 🫵 🫶 💑 👩‍❤️‍👨 👨‍❤️‍👨 👩‍❤️‍👩
young	young 👶 🧒 👦 👧 🌱
younger	younger 🧒 👦 👧
yum	yum 😋 😒 🍴
yummy	yummy 😋 🍴
yup	yup 💯
yurt	yurt 🛖
yuèbǐng	yuèbǐng 🥮
zambia	zambia 🇿🇲
zany	zany 🤪
zap	zap ⚡
zebra	zebra 🦓
zen	zen 😌 🧘 🧘‍♂️ 🧘‍♀️
zero	zero 📥 0️⃣
zest	zest 🍋‍🟩
zimbabwe	zimbabwe 🇿🇼
zip	zip 🤐 😒 🤌
zipper	zipper 🤐
zipper-mouth	zipper-mouth 🤐
zodiac	zodiac 👧 🦁 🐂 🐏 🐐 🐍 🐟 🦀 🦂 🏺 🏹 ⚖ ♈ ♉ ♊ ♋ ♌ ♍ ♎ ♏ ♐ ♑ ♒ ♓ ⛎
zombie	zombie 🧟 🧟‍♂️ 🧟‍♀️
zoo	zoo 🐅 🐆 🐃 🐏 🐊
zoom	zoom 🏎
zzz	zzz 😴 🥱 💤 🛌
zōri	zōri 🩴
×	× ✖ ❌ ❎
ålandislands	ålandislands 🇦🇽
÷	÷ ➗
−	− ➖
⊛flag	⊛flag 🇨🇶
♪	♪ 🔣
✓	✓ ✅ ☑ ✔
〒	〒 🔣
